NOMBRE	ACTIVIDAD	DIRECCION		
CASA DEL HISTORIADOR - ARCHIVO HISTORICO DE LA CIUDAD DE BUENOS AIRES	ARCHIVO	BOLIVAR 466		
ESPACIO VIRREY LINIERS	ARCHIVO	VENEZUELA 469		
BIBLIOTECA  CANONIGO LUIS JOSE DE CHORROARIN	BIBLIOTECA	SOLDADO DE LA FRONTERA AV. 5059		
BIBLIOTECA ALFONSINA STORNI	BIBLIOTECA	VENEZUELA 1538		
BIBLIOTECA ALVARO YUNQUE	BIBLIOTECA	SOLDADO DE LA FRONTERA AV. 5210		
BIBLIOTECA ANTONIO DEVOTO (CON ANEXO INFANTIL)	BIBLIOTECA	BAHIA BLANCA 4025		
BIBLIOTECA BALDOMERO FERNANDEZ MORENO	BIBLIOTECA	ARENAL, CONCEPCION 4206		
BIBLIOTECA BENITO LYNCH (CON ANEXO INFANTIL)	BIBLIOTECA	YRUPE 6714		
BIBLIOTECA BRIGADIER GENERAL CORNELIO SAAVEDRA	BIBLIOTECA	LARRALDE, CRISOLOGO AV. 6293		
BIBLIOTECA CARLOS GUIDO Y SPANO	BIBLIOTECA	GUEMES 4601		
BIBLIOTECA CIRCE - BIBLIOTECA TESORO	BIBLIOTECA	CORDOBA AV. 1558		
BIBLIOTECA ENRIQUE BANCHS (INFANTO JUVENIL)	BIBLIOTECA	CASEROS AV. 3100		
BIBLIOTECA ESTANISLAO DEL CAMPO	BIBLIOTECA	DE LAS ARTES 1210		
BIBLIOTECA EVARISTO CARRIEGO	BIBLIOTECA	HONDURAS 3784		
BIBLIOTECA HILARIO ASCASUBI	BIBLIOTECA	DIAZ, CESAR, GRAL. 4219		
BIBLIOTECA JAVIER VILLAFAÑE (CON ANEXO INFANTIL)	BIBLIOTECA	JANER, ANA MARIA Y TORRES Y TENORIO, PRES.		
BIBLIOTECA JOAQUIN V. GONZALEZ (CON ANEXO INFANTIL)	BIBLIOTECA	SUAREZ 408		
BIBLIOTECA JOSE HERNANDEZ	BIBLIOTECA	BOQUERON 6753		
BIBLIOTECA JOSE MARMOL	BIBLIOTECA	JURAMENTO 2937		
BIBLIOTECA JULIO CESAR SAGUIER (CON ANEXO INFANTIL)	BIBLIOTECA	DELLEPIANE, LUIS, TTE. GRAL. 4801		
BIBLIOTECA JULIO CORTAZAR / CASA DE LA LECTURA	BIBLIOTECA	LAVALLEJA 924		
BIBLIOTECA LA PRENSA	BIBLIOTECA	PAZ, JOSE C. 3300		
BIBLIOTECA REINA BATATA (INFANTO JUVENIL)	BIBLIOTECA	11 DE SEPTIEMBRE DE 1888 Y LA PAMPA		
BIBLIOTECA LEOPOLDO LUGONES	BIBLIOTECA	LA PAMPA 2215		
BIBLIOTECA MANUEL GALVEZ	BIBLIOTECA	CORDOBA AV. 1558		
BIBLIOTECA MARIANO PELLIZA	BIBLIOTECA	CRANWELL 819		
BIBLIOTECA MARTIN DEL BARCO CENTENERA (CON ANEXO DE GENERO)	BIBLIOTECA	VENEZUELA 1538		
BIBLIOTECA MIGUEL CANE (CON ANEXO INFANTIL)	BIBLIOTECA	CALVO, CARLOS AV. 4319		
BIBLIOTECA NORAH LANGE	BIBLIOTECA	FERNANDEZ DE LA CRUZ, F., GRAL. AV. Y ESCALADA AV.		
BIBLIOTECA RAFAEL OBLIGADO	BIBLIOTECA	CRAINQUEVILLE 2233		
BIBLIOTECA RICARDO GUIRALDES	BIBLIOTECA	TALCAHUANO 1261		
CASA DE LA LECTURA - ESPACIO CULTURAL	BIBLIOTECA	LAVALLEJA 924		
CASA DE LA CULTURA	CENTRO CULTURAL	DE MAYO AV. 575		
CENTRO CULTURAL ALBERTO OLMEDO	CENTRO CULTURAL	VIALE, LUIS 1052		
CENTRO CULTURAL ALFONSINA STORNI	CENTRO CULTURAL	TUCUMAN 3233		
CENTRO CULTURAL BALDOMERO FERNANDEZ MORENO	CENTRO CULTURAL	MERCEDES 1405		
CENTRO CULTURAL GENERAL SAN MARTIN	CENTRO CULTURAL	SARMIENTO 1551		
CENTRO CULTURAL NUESTRA TIERRA	CENTRO CULTURAL	IRIARTE, GRAL. AV. Y MONTESQUIEU		
CENTRO CULTURAL RECOLETA	CENTRO CULTURAL	JUNIN 1930		
CENTRO CULTURAL TATO BORES	CENTRO CULTURAL	SOLER 3929		
COMPLEJO CULTURAL CHACRA DE LOS REMEDIOS	CENTRO CULTURAL	DIRECTORIO AV. Y LACARRA		
LA VIDRIERA DE LA DGEART	CENTRO CULTURAL	PERU 374		
USINA DEL ARTE	CENTRO CULTURAL	DON PEDRO DE MENDOZA AV. Y CAFFARENA, AGUSTIN R.		
CENTRO CULTURAL ADAN BUENOS AYRES	CENTRO CULTURAL	ASAMBLEA AV. 1200		
CENTRO CULTURAL ANIBAL TROILO	CENTRO CULTURAL	GORRITI 5740		
CENTRO CULTURAL ARTES DE PARQUE CHACABUCO	CENTRO CULTURAL	CACHIMAYO 1657		
CENTRO CULTURAL BARRIO COPELLO	CENTRO CULTURAL	DELLEPIANE, LUIS, TTE. GRAL. 4900		
CENTRO CULTURAL BARRIO RIVADAVIA	CENTRO CULTURAL	COBO AV. Y CURAPALIGUE		
CENTRO CULTURAL BELGRANO R.	CENTRO CULTURAL	LA PAMPA 3855		
CENTRO CULTURAL BOEDO	CENTRO CULTURAL	CASTRO 954		
CENTRO CULTURAL CEPNA (CENTRO DE ESTUDIOS Y PROYECTOS NUEVA ARGENTINA)	CENTRO CULTURAL	MURGUIONDO 4361		
CENTRO CULTURAL COLEGIALES	CENTRO CULTURAL	CONDE 943		
CENTRO CULTURAL DEL BAJO FLORES	CENTRO CULTURAL	RIESTRA AV. 1650		
CENTRO CULTURAL DEL SUR	CENTRO CULTURAL	CASEROS AV. 1750		
CENTRO CULTURAL DEVOTO	CENTRO CULTURAL	NUEVA YORK 4169		
CENTRO CULTURAL DISCEPOLIN	CENTRO CULTURAL	TRONADOR 4134		
CENTRO CULTURAL EL ETERNAUTA	CENTRO CULTURAL	LOBOS, ELEODORO, DR. 437		
CENTRO CULTURAL EL TALLER	CENTRO CULTURAL	GONZALEZ, ELPIDIO 4967		
CENTRO CULTURAL ELADIA BLAZQUEZ	CENTRO CULTURAL	RABANAL, FRANCISCO, INTENDENTE AV. 2275		
CENTRO CULTURAL ELIAS CASTELNUOVO	CENTRO CULTURAL	MONTIEL 1041		
CENTRO CULTURAL FORTUNATO LACAMERA	CENTRO CULTURAL	SAN JUAN AV. 353		
CENTRO CULTURAL HOMERO MANZI	CENTRO CULTURAL	TILCARA 3365		
CENTRO CULTURAL JUAN CARLOS CASTAGNINO	CENTRO CULTURAL	PAZ, GRAL. AV. Y 2 DE ABRIL DE 1982		
CENTRO CULTURAL JULIO CORTAZAR	CENTRO CULTURAL	O'HIGGINS 3050		
CENTRO CULTURAL LA CASITA DE LA SELVA	CENTRO CULTURAL	LA SELVA 4022		
CENTRO CULTURAL LA PATERNAL - VILLA MITRE	CENTRO CULTURAL	CARACAS 1249		
CENTRO CULTURAL LA USINA	CENTRO CULTURAL	SANTO DOMINGO 2752		
CENTRO CULTURAL LINO E. SPILIMBERGO	CENTRO CULTURAL	PEREZ, ROQUE 3545		
CENTRO CULTURAL LOLA MORA	CENTRO CULTURAL	RIO DE JANEIRO 946		
CENTRO CULTURAL MACEDONIO FERNANDEZ	CENTRO CULTURAL	LEGUIZAMON, MARTINIANO 1470		
CENTRO CULTURAL MARCO DEL PONT	CENTRO CULTURAL	ARTIGAS, JOSE GERVASIO, GRAL. 202		
CENTRO CULTURAL OSVALDO PUGLIESE	CENTRO CULTURAL	ARAOZ 234		
CENTRO CULTURAL PLAZA DEFENSA	CENTRO CULTURAL	DEFENSA 535		
CENTRO CULTURAL RESURGIMIENTO	CENTRO CULTURAL	ARTIGAS, JOSE GERVASIO, GRAL. 2262		
CENTRO CULTURAL ROBERTO ARLT	CENTRO CULTURAL	AVELLANEDA AV. 2547		
CENTRO CULTURAL ROBERTO SANTORO	CENTRO CULTURAL	GIRIBONE 1961		
CENTRO CULTURAL SALADIYO	CENTRO CULTURAL	BERON DE ASTRADA 5920		
CENTRO CULTURAL SEBASTIAN PIANA	CENTRO CULTURAL	PUAN 360		
CENTRO CULTURAL VERSALLES	CENTRO CULTURAL	BRUSELAS 785		
ESPACIO CULTURAL CARLOS GARDEL	CENTRO CULTURAL	OLLEROS 3640		
ESPACIO CULTURAL JULIAN CENTEYA	CENTRO CULTURAL	SAN JUAN AV. 3255		
CINE EL PLATA	CINE	ALBERDI, JUAN BAUTISTA AV. 5751		
POLO CIRCO	CIRCO	COMBATE DE LOS POZOS Y GARAY, JUAN DE AV.		
CONSERVATORIO SUPERIOR DE MUSICA DE LA CIUDAD DE BS. AS. ASTOR PIAZZOLLA	ESPACIO DE FORMACION (CARRERAS, SEMINARIOS Y TALLERES)	SARMIENTO 3401		
CONSERVATORIO SUPERIOR DE MUSICA MANUEL DE FALLA - ANEXO 1	ESPACIO DE FORMACION (CARRERAS, SEMINARIOS Y TALLERES)	BARCO CENTENERA DEL 741		
CONSERVATORIO SUPERIOR DE MUSICA MANUEL DE FALLA - ANEXO 2	ESPACIO DE FORMACION (CARRERAS, SEMINARIOS Y TALLERES)	SALGUERO, JERONIMO 2445		
CONSERVATORIO SUPERIOR DE MUSICA MANUEL DE FALLA - ANEXO 3	ESPACIO DE FORMACION (CARRERAS, SEMINARIOS Y TALLERES)	HUMBERTO 1 3171		
CONSERVATORIO SUPERIOR DE MUSICA MANUEL DE FALLA - ANEXO 4	ESPACIO DE FORMACION (CARRERAS, SEMINARIOS Y TALLERES)	CAMARGO 725		
CONSERVATORIO SUPERIOR DE MUSICA MANUEL DE FALLA - SEDE CENTRAL	ESPACIO DE FORMACION (CARRERAS, SEMINARIOS Y TALLERES)	GALLO 238		
ESCUELA METROPOLITANA DE ARTE DRAMATICA - ANEXO 1	ESPACIO DE FORMACION (CARRERAS, SEMINARIOS Y TALLERES)	JUFRE 141		
ESCUELA METROPOLITANA DE ARTE DRAMATICO	ESPACIO DE FORMACION (CARRERAS, SEMINARIOS Y TALLERES)	SARMIENTO 2573		
ESPACIO TEATRAL LOS ANDES	ESPACIO DE FORMACION (CARRERAS, SEMINARIOS Y TALLERES)	LEIVA 4249		
ESTUDIO URBANO	ESPACIO DE FORMACION (CARRERAS, SEMINARIOS Y TALLERES)	CURAPALIGUE 585		
INSTITUTO DE INVESTIGACION EN ETNOMUSICOLOGIA	ESPACIO DE FORMACION (CARRERAS, SEMINARIOS Y TALLERES)	BOLIVAR 191		
INSTITUTO VOCACIONAL DE ARTE MANUEL JOSE DE LABARDEN - ANEXO 1	ESPACIO DE FORMACION (CARRERAS, SEMINARIOS Y TALLERES)	CURAPALIGUE AV. 1026		
INSTITUTO VOCACIONAL DE ARTE MANUEL JOSE DE LABARDEN - ANEXO 2	ESPACIO DE FORMACION (CARRERAS, SEMINARIOS Y TALLERES)	COLLIVADINO, PIO 470		
INSTITUTO VOCACIONAL DE ARTE MANUEL JOSE DE LABARDEN - SEDE CENTRAL	ESPACIO DE FORMACION (CARRERAS, SEMINARIOS Y TALLERES)	GARAY, JUAN DE AV. 1684		
RECREO DE LAS ARTES - SEDE CONSTITUCION	ESPACIO DE FORMACION (CARRERAS, SEMINARIOS Y TALLERES)	SOLIS 1815		
RECREO DE LAS ARTES - SEDE LA BOCA	ESPACIO DE FORMACION (CARRERAS, SEMINARIOS Y TALLERES)	ROCHA 1226		
AUDITORIO EVA PERON - PARQUE CENTENARIO	ESPACIO ESCENICO (TEATRO, MUSICA Y DANZA)	PATRICIAS ARGENTINAS AV. Y LILLO AV.		
TEATRO 25 DE MAYO	ESPACIO ESCENICO (TEATRO, MUSICA Y DANZA)	TRIUNVIRATO AV. 4444		
TEATRO COLON	ESPACIO ESCENICO (TEATRO, MUSICA Y DANZA)	CERRITO 618		
TEATRO DE LA RIBERA	ESPACIO ESCENICO (TEATRO, MUSICA Y DANZA)	DON PEDRO DE MENDOZA AV. 1821		
TEATRO GENERAL SAN MARTIN	ESPACIO ESCENICO (TEATRO, MUSICA Y DANZA)	CORRIENTES AV. 1530		
TEATRO PRESIDENTE ALVEAR	ESPACIO ESCENICO (TEATRO, MUSICA Y DANZA)	CORRIENTES AV. 1659		
TEATRO REGIO	ESPACIO ESCENICO (TEATRO, MUSICA Y DANZA)	CORDOBA AV. 6065		
TEATRO SARMIENTO	ESPACIO ESCENICO (TEATRO, MUSICA Y DANZA)	SARMIENTO AV. 2715		
CASA HISTORICA ISAAC FERNANDEZ BLANCO	MUSEO	YRIGOYEN, HIPOLITO 1420		
CENTRO DE MUSEOS DE BUENOS AIRES (DIRECCION GENERAL DE MUSEOS)	MUSEO	DE LOS ITALIANOS AV. Y VILLAFLOR, AZUCENA		
MUSEO CASA CARLOS GARDEL	MUSEO	JAURES, JEAN 735		
MUSEO DE ARTE ESPAÑOL ENRIQUE LARRETA	MUSEO	JURAMENTO AV. 2291		
MUSEO DE ARTE HISPANOAMERICANO ISAAC FERNANDEZ BLANCO	MUSEO	SUIPACHA 1422		
MUSEO DE ARTE MODERNO DE BUENOS AIRES	MUSEO	SAN JUAN AV. 350		
MUSEO DE ARTE POPULAR JOSE HERNANDEZ	MUSEO	DEL LIBERTADOR AV. 2373		
MUSEO DE ARTES PLASTICAS EDUARDO SIVORI	MUSEO	ISABEL, INFANTA AV. 555		
MUSEO DE ESCULTURAS LUIS PERLOTTI	MUSEO	PUJOL 642		
MUSEO DE LA CIUDAD	MUSEO	DEFENSA 219		
MUSEO DEL CINE PABLO DUCROS HICKEN (SEDE CAFFARENA)	MUSEO	CAFFARENA, AGUSTIN R. 49		
MUSEO DEL CINE PABLO DUCROS HICKEN (SEDE FEIJOO)	MUSEO	SALMUN FEIJOO, JOSE AARON 555		
MUSEO DEL HUMOR (MUHU)	MUSEO	DE LOS ITALIANOS AV. Y VILLAFLOR, AZUCENA		
MUSEO HISTORICO DE BUENOS AIRES CORNELIO DE SAAVEDRA	MUSEO	LARRALDE, CRISOLOGO AV. 6309		
TORRE MONUMENTAL - CENTRO DE INFORMES DE MUSEOS	MUSEO	DEL LIBERTADOR AV. 49		
FERIA DE MATADEROS	PEÑA	DE LOS CORRALES AV. 6501		
"PLANETARIO DE LA CIUDAD DE BUENOS AIRES ""GALILEO GALILEI"""	PLANETARIO	SARMIENTO AV. Y ROLDAN, BELISARIO AV.		
CAFE VICTORIA	BAR NOTABLE	ENTRE RIOS AV. 114		
VARELA VARELITA	BAR NOTABLE	SCALABRINI ORTIZ, RAUL AV. 2102		
PLAZA CAFE	BAR NOTABLE	RIVADAVIA AV. 4732		
8 ESQUINAS	BAR NOTABLE	FOREST AV. 1186		
MODENA DESING	BAR NOTABLE	FIGUEROA ALCORTA, PRES. AV. 2270		
LA PERLA BAR	BAR NOTABLE	JUJUY AV. 36		
LA NUEVA ANDALUZA	BAR NOTABLE	CAMARONES 1412		
LA FLOR DE BARRACAS	BAR NOTABLE	SUAREZ AV. 2095		
LA ACADEMIA	BAR NOTABLE	CALLAO AV. 368		
CAPISCI	BAR NOTABLE	VUELTA DE OBLIGADO 2072		
CAFFE TABAC	BAR NOTABLE	DEL LIBERTADOR AV. 2300		
CAFE ROMA	BAR NOTABLE	OLAVARRIA 409		
CAFE PALACIO	BAR NOTABLE	LACROZE, FEDERICO AV. 3901		
CAFE DE LA U	BAR NOTABLE	TRIUNVIRATO AV. 4801		
CAFE DE LA ESQUINA	BAR NOTABLE	DEL LIBERTADOR AV. 6169		
BOSTON CITY	BAR NOTABLE	FLORIDA 165		
LA FARMACIA	BAR NOTABLE	DIRECTORIO AV. 2400		
TOKIO	BAR NOTABLE	ALVAREZ JONTE AV. 3550		
THE BRIGHTON	BAR NOTABLE	SARMIENTO 645		
PETIT COLON	BAR NOTABLE	LIBERTAD 505		
MIRAMAR	BAR NOTABLE	SARANDI 1190		
LONDON CITY	BAR NOTABLE	DE MAYO AV. 599		
LAS VIOLETAS	BAR NOTABLE	RIVADAVIA AV. 3899		
LA POESIA	BAR NOTABLE	CHILE 502		
LA GIRALDA	BAR NOTABLE	CORRIENTES AV. 1453		
LA CORUÑA	BAR NOTABLE	BOLIVAR 982		
LA BIELA	BAR NOTABLE	QUINTANA, MANUEL, PRES. AV. 600		
FLORIDA GARDEN	BAR NOTABLE	FLORIDA 899		
EL PROGRESO	BAR NOTABLE	MONTES DE OCA, MANUEL 1702		
HIPOPOTAMO	BAR NOTABLE	BRASIL 401		
EL FARO	BAR NOTABLE	DE LOS CONSTITUYENTES AV. 4099		
CONFITERIA SAINT MORITZ	BAR NOTABLE	ESMERALDA 894		
PLAZA BAR	BAR NOTABLE	FLORIDA 1005		
OLIMPO	BAR NOTABLE	ARREGUI 5794		
LOS LAURELES	BAR NOTABLE	IRIARTE, GRAL. AV. 2290		
LE CARAVELLE	BAR NOTABLE	LAVALLE 726		
LA PUERTO RICO	BAR NOTABLE	ALSINA, ADOLFO 416		
LA PERLA	BAR NOTABLE	DON PEDRO DE MENDOZA AV. 1891		
LA EMBAJADA	BAR NOTABLE	SANTIAGO DEL ESTERO 88		
LA BUENA MEDIDA	BAR NOTABLE	SUAREZ 101		
IBERIA	BAR NOTABLE	DE MAYO AV. 1196		
EL QUERANDI	BAR NOTABLE	PERU 302		
EL PREFERIDO DE PALERMO	BAR NOTABLE	BORGES, JORGE LUIS 2108		
EL GATO NEGRO	BAR NOTABLE	CORRIENTES AV. 1669		
CONFITERIA IDEAL	BAR NOTABLE	SUIPACHA 384		
CLASICA Y MODERNA	BAR NOTABLE	CALLAO AV. 892		
CAFE RETIRO	BAR NOTABLE	RAMOS MEJIA, JOSE MARIA, DR. AV. 1358		
CAFE MARGOT	BAR NOTABLE	BOEDO AV. 857		
LOS GALGOS	BAR NOTABLE	CALLAO AV. 501		
EL COLECCIONISTA	BAR NOTABLE	RIVADAVIA AV. 4929		
DON JUAN	BAR NOTABLE	CAMARONES 2702		
CAFE DE GARCIA	BAR NOTABLE	SANABRIA 3302		
BAR SUR	BAR NOTABLE	ESTADOS UNIDOS 299		
CONFITERIA DEL HOTEL CASTELAR	BAR NOTABLE	DE MAYO AV. 1048		
CLARIDGE BAR	BAR NOTABLE	TUCUMAN 535		
CAFE TORTONI	BAR NOTABLE	DE MAYO AV. 825		
CAFE NOSTALGIA	BAR NOTABLE	SOLER 3599		
CAFE MAR AZUL	BAR NOTABLE	TUCUMAN 1700		
ESQUINA HOMERO MANZI	BAR NOTABLE	SAN JUAN AV. 3601		
CAFE EL BANDERIN	BAR NOTABLE	GUARDIA VIEJA 3601		
CAFE DE LOS ANGELITOS	BAR NOTABLE	RIVADAVIA AV. 2100		
BAR BRITANICO	BAR NOTABLE	BRASIL AV. 399		
BAR SEDDON	BAR NOTABLE	DEFENSA 695		
BAR OVIEDO	BAR NOTABLE	DE LA TORRE, LISANDRO AV. 2407		
BAR EL FEDERAL	BAR NOTABLE	CALVO, CARLOS 395		
BAR DEL HOTEL ALVEAR	BAR NOTABLE	ALVEAR AV. 1891		
36 BILLARES	BAR NOTABLE	DE MAYO AV. 1265		
BAR PLAZA DORREGO	BAR NOTABLE	DEFENSA 1096		
BARBARO - BAR O BAR	BAR CULTURAL	TRES SARGENTOS 415		
BAR EL ESTAÑO 1880	BAR NOTABLE	VALLE, ARISTOBULO DEL 1100		
BAR DE CAO	BAR NOTABLE	INDEPENDENCIA AV. 2400		
AMERICAN BAR	BAR NOTABLE	SAENZ PE�A, ROQUE, PRES. AV. 632		
12 DE OCTUBRE (BAR DE ROBERTO)	BAR NOTABLE	BULNES 331		
CLUB CULTURAL MATIENZO	ESPACIO ESCENICO (TEATRO, MUSICA Y DANZA)	PRINGLES 1249		
BIBLIOTECA POPULAR ARGENTINA PARA CIEGOS	BIBLIOTECA	LEZICA 3909		
BIBLIOTECA POPULAR GENERAL ALVEAR	BIBLIOTECA	AVELLANEDA 542		
CLUB OBRAS SANITARIAS DE LA NACION	ESPACIO ESCENICO (TEATRO, MUSICA Y DANZA)	DEL LIBERTADOR AV. 7395		
BIBLIOTECA POPULAR ALBERTO GERCHUNOFF	BIBLIOTECA	SARMIENTO 2233		
BIBLIOTECA POPULAR GRAL. BENITO NAZAR	BIBLIOTECA	ANTEZANA 340		
BIBLIOTECA POPULAR JUAN MARIA BECCIU	BIBLIOTECA	GRANADA, NICOLAS 1660		
BIBLIOTECA POPULAR EL RESPLANDOR	BIBLIOTECA	LLERENA 2727		
OPERA CITI	ESPACIO ESCENICO (TEATRO, MUSICA Y DANZA)	CORRIENTES AV. 860		
MOLIERE CAFE CONCERT	ESPACIO ESCENICO (TEATRO, MUSICA Y DANZA)	CHILE AV. 299		
GRUPO DE TEATRO COMUNITARIO POMPAPETRIYASS DE PARQUE PATRICIOS	ESPACIO ESCENICO (TEATRO, MUSICA Y DANZA)	LUCA, ESTEBAN DE Y BRASIL		
BRILLA CORDELIA	ESPACIO ESCENICO (TEATRO, MUSICA Y DANZA)	PERON, JUAN DOMINGO, TTE. GENERAL 1926		
QUERIDA ELENA	ESPACIO ESCENICO (TEATRO, MUSICA Y DANZA)	PI Y MARGALL 1124		
ESPACIO TBK	ESPACIO ESCENICO (TEATRO, MUSICA Y DANZA)	TRELLES, MANUEL R. 2033		
TEATRO PAYRO	ESPACIO ESCENICO (TEATRO, MUSICA Y DANZA)	SAN MARTIN 766		
TEATRO DEL ARTEFACTO	ESPACIO ESCENICO (TEATRO, MUSICA Y DANZA)	SARANDI 760		
DEL BORDE ESPACIO TEATRAL	ESPACIO ESCENICO (TEATRO, MUSICA Y DANZA)	CHILE 630		
EL SOTANO	ESPACIO ESCENICO (TEATRO, MUSICA Y DANZA)	GARCIA, TEODORO 3234		
SOCIEDAD HEBRAICA ARGENTINA (SHA)	ESPACIO ESCENICO (TEATRO, MUSICA Y DANZA)	SARMIENTO 2233		
ESPACIO CULTURAL C.E.I.A.C	ESPACIO ESCENICO (TEATRO, MUSICA Y DANZA)	FREIRE, RAMON, CAP. GRAL. 1658		
LA SODERIA	ESPACIO ESCENICO (TEATRO, MUSICA Y DANZA)	VIDAL 2549		
EL ARBOL, CENTRO DE INVESTIGACION TEATRAL	ESPACIO ESCENICO (TEATRO, MUSICA Y DANZA)	14 DE JULIO 1261		
CLUB DEL PROGRESO	ESPACIO ESCENICO (TEATRO, MUSICA Y DANZA)	SARMIENTO 1334		
LA ESCALERA ESPACIO DE ARTE	ESPACIO ESCENICO (TEATRO, MUSICA Y DANZA)	JUSTO, JUAN B. AV. 889		
CLUB ITALIANO	ESPACIO ESCENICO (TEATRO, MUSICA Y DANZA)	RIVADAVIA AV. 4731		
EL GALPON DE CATALINAS	ESPACIO ESCENICO (TEATRO, MUSICA Y DANZA)	PEREZ GALDOS, BENITO AV. 93		
BOEDO XXI ESPACIO DE TEATRO	ESPACIO ESCENICO (TEATRO, MUSICA Y DANZA)	BOEDO AV. 853		
EMPIRE	ESPACIO ESCENICO (TEATRO, MUSICA Y DANZA)	YRIGOYEN, HIPOLITO 1934		
EL DESGUACE, TEATRO Y ALMACEN CULTURAL	ESPACIO ESCENICO (TEATRO, MUSICA Y DANZA)	MEXICO 3694		
TEATRO AVENIDA	ESPACIO ESCENICO (TEATRO, MUSICA Y DANZA)	DE MAYO AV. 1220		
TERRAZA TEATRO BAR	ESPACIO ESCENICO (TEATRO, MUSICA Y DANZA)	CORRIENTES AV. 1660		
EL VICTORIAL	ESPACIO ESCENICO (TEATRO, MUSICA Y DANZA)	PIEDRAS 722		
LA SALITA ESPACIO CULTURAL	ESPACIO ESCENICO (TEATRO, MUSICA Y DANZA)	YRIGOYEN, HIPOLITO 1362		
TEATRO TALLER EL GRITO	ESPACIO ESCENICO (TEATRO, MUSICA Y DANZA)	COSTA RICA 5459		
EL FINO ESPACIO CULTURAL	ESPACIO ESCENICO (TEATRO, MUSICA Y DANZA)	PARANA 673		
MACHADO	ESPACIO ESCENICO (TEATRO, MUSICA Y DANZA)	MACHADO, ANTONIO 617		
ESTUDIO ROBERTO SAIZ	ESPACIO ESCENICO (TEATRO, MUSICA Y DANZA)	DE MAYO AV. 1430		
AUDITORIO HOTEL BAUEN	ESPACIO ESCENICO (TEATRO, MUSICA Y DANZA)	CALLAO AV. 360		
PASEO LA PLAZA	ESPACIO ESCENICO (TEATRO, MUSICA Y DANZA)	CORRIENTES AV. 1660		
TEATRO CALIBAN	ESPACIO ESCENICO (TEATRO, MUSICA Y DANZA)	MEXICO 1428		
BAJO CORRIENTES	ESPACIO ESCENICO (TEATRO, MUSICA Y DANZA)	CORRIENTES AV. 1632		
ANGEL DEL ABASTO	ESPACIO ESCENICO (TEATRO, MUSICA Y DANZA)	ZELAYA 3122		
LA CHILINGA	ESPACIO DE FORMACION (CARRERAS, SEMINARIOS Y TALLERES)	RUIZ HUIDOBRO AV. 4228		
LA FUGA CABRERA	ESPACIO ESCENICO (TEATRO, MUSICA Y DANZA)	CABRERA, JOSE A. 4871		
TEATRO REGINA - CASA DEL TEATRO	ESPACIO ESCENICO (TEATRO, MUSICA Y DANZA)	SANTA FE AV. 1243		
EL ATAJO	ESPACIO ESCENICO (TEATRO, MUSICA Y DANZA)	MONTAÃ‘ESES 1977		
TEATRO ABSURDO DE PALERMO	ESPACIO ESCENICO (TEATRO, MUSICA Y DANZA)	RAVIGNANI, EMILIO, DR. 1557		
MADERA DE SUEÑOS	ESPACIO ESCENICO (TEATRO, MUSICA Y DANZA)	JUFRE 375		
CORRIENTE AZUL	ESPACIO ESCENICO (TEATRO, MUSICA Y DANZA)	CORRIENTES AV. 5965		
EL FARABUTE	ESPACIO ESCENICO (TEATRO, MUSICA Y DANZA)	CORRIENTES AV. 5534		
TEATRO COLISEO	ESPACIO ESCENICO (TEATRO, MUSICA Y DANZA)	ALVEAR, MARCELO T. DE 1125		
CINE TEATRO SAN PEDRO	ESPACIO ESCENICO (TEATRO, MUSICA Y DANZA)	BERMUDEZ 2052		
EL DOBLE	ESPACIO ESCENICO (TEATRO, MUSICA Y DANZA)	ARAOZ 727		
LA OTRA ORILLA	ESPACIO ESCENICO (TEATRO, MUSICA Y DANZA)	URQUIZA, GRAL. 124		
AUDITORIO BEN AMI	ESPACIO ESCENICO (TEATRO, MUSICA Y DANZA)	JAURES, JEAN 746		
PAN Y ARTE / BOEDO VIDA Y ARTE	ESPACIO ESCENICO (TEATRO, MUSICA Y DANZA)	BOEDO AV. 876		
TEMPLUM	ESPACIO ESCENICO (TEATRO, MUSICA Y DANZA)	AYACUCHO 318		
TEATRO LA CASONA	ESPACIO ESCENICO (TEATRO, MUSICA Y DANZA)	CORRIENTES AV. 1975		
CENTRO ARGENTINO DE TEATRO CIEGO	ESPACIO ESCENICO (TEATRO, MUSICA Y DANZA)	ZELAYA 3006		
THE CAVERN CLUB	ESPACIO ESCENICO (TEATRO, MUSICA Y DANZA)	CORRIENTES AV. 1660		
GRUPO DE TEATRO COMUNITARIO RES O NO RES	ESPACIO ESCENICO (TEATRO, MUSICA Y DANZA)	DIRECTORIO AV. Y DE LA TORRE, LISANDRO AV.		
EL PISO	ESPACIO ESCENICO (TEATRO, MUSICA Y DANZA)	HIDALGO 878		
EL EPICO DE FLORESTA	ESPACIO ESCENICO (TEATRO, MUSICA Y DANZA)	GAONA AV. 4660		
DANDELION	ESPACIO ESCENICO (TEATRO, MUSICA Y DANZA)	CORDOBA AV. 2429		
IFT	ESPACIO ESCENICO (TEATRO, MUSICA Y DANZA)	BOULOGNE SUR MER 549		
TEATRO DEL ANGEL	ESPACIO ESCENICO (TEATRO, MUSICA Y DANZA)	BRAVO, MARIO 1239		
TEATRO PICCOLINO	ESPACIO ESCENICO (TEATRO, MUSICA Y DANZA)	FITZ ROY 2056		
CHACAREREAN TEATRE	ESPACIO ESCENICO (TEATRO, MUSICA Y DANZA)	NICARAGUA 5565		
TEATRO DEL ABASTO	ESPACIO ESCENICO (TEATRO, MUSICA Y DANZA)	HUMAHUACA 3549		
ESPACIO CULTURAL PATA DE GANSO	ESPACIO ESCENICO (TEATRO, MUSICA Y DANZA)	ZELAYA 3122		
CENDAS AUDITORIO	ESPACIO ESCENICO (TEATRO, MUSICA Y DANZA)	BULNES 1350		
DE LA FABULA	ESPACIO ESCENICO (TEATRO, MUSICA Y DANZA)	AGUERO 444		
EL PORTON DE SANCHEZ	ESPACIO ESCENICO (TEATRO, MUSICA Y DANZA)	SANCHEZ DE BUSTAMANTE 1034		
ANDAMIO 90	ESPACIO ESCENICO (TEATRO, MUSICA Y DANZA)	PARANA 662		
MARGARITA XIRGU	ESPACIO ESCENICO (TEATRO, MUSICA Y DANZA)	CHACABUCO 875		
TEATRO MAIPO	ESPACIO ESCENICO (TEATRO, MUSICA Y DANZA)	ESMERALDA 443		
TEATRO EL NACIONAL	ESPACIO ESCENICO (TEATRO, MUSICA Y DANZA)	CORRIENTES AV. 960		
TABARIS	ESPACIO ESCENICO (TEATRO, MUSICA Y DANZA)	CORRIENTES AV. 829		
ASTROS	ESPACIO ESCENICO (TEATRO, MUSICA Y DANZA)	CORRIENTES AV. 746		
MULTITEATRO	ESPACIO ESCENICO (TEATRO, MUSICA Y DANZA)	CORRIENTES AV. 1283		
TEATRO DEL PUEBLO	ESPACIO ESCENICO (TEATRO, MUSICA Y DANZA)	SAENZ PE�A, ROQUE, PRES. AV. 943		
TEATRO METROPOLITAN	ESPACIO ESCENICO (TEATRO, MUSICA Y DANZA)	CORRIENTES AV. 1343		
TEATRO NACIONAL CERVANTES	ESPACIO ESCENICO (TEATRO, MUSICA Y DANZA)	CORDOBA AV. 1155		
ESTADIO LUNA PARK	ESPACIO ESCENICO (TEATRO, MUSICA Y DANZA)	BOUCHARD 465		
SPORTIVO TEATRAL	ESPACIO ESCENICO (TEATRO, MUSICA Y DANZA)	THAMES 1426		
EL DUENDE TEATRO	ESPACIO ESCENICO (TEATRO, MUSICA Y DANZA)	ARAOZ 1469		
SANTA MARIA DEL BUEN AYRE	ESPACIO ESCENICO (TEATRO, MUSICA Y DANZA)	MONTEVIDEO 842		
LA BIBLIOTECA CAFE	ESPACIO ESCENICO (TEATRO, MUSICA Y DANZA)	ALVEAR, MARCELO T. DE 1155		
TEATRO ORFEO	ESPACIO ESCENICO (TEATRO, MUSICA Y DANZA)	CAMPOS, LUIS M. AV. 1375		
TEATRO ASTRAL	ESPACIO ESCENICO (TEATRO, MUSICA Y DANZA)	CORRIENTES AV. 1639		
ESPACIO ECLECTICO	ESPACIO ESCENICO (TEATRO, MUSICA Y DANZA)	HUMBERTO 1 730		
SALA CARLOS CARELLA	ESPACIO ESCENICO (TEATRO, MUSICA Y DANZA)	MITRE, BARTOLOME 970		
BECKETT TEATRO	ESPACIO ESCENICO (TEATRO, MUSICA Y DANZA)	GUARDIA VIEJA 3556		
CODIGO MONTESCO	ESPACIO ESCENICO (TEATRO, MUSICA Y DANZA)	GORRITI 3956		
LA TRASTIENDA	ESPACIO ESCENICO (TEATRO, MUSICA Y DANZA)	BALCARCE 460		
ESPACIO ABIERTO	ESPACIO ESCENICO (TEATRO, MUSICA Y DANZA)	CARABELAS 255		
ACADEMIA PORTEÑA DEL LUNFARDO	ESPACIO DE FORMACION (CARRERAS, SEMINARIOS Y TALLERES)	ESTADOS UNIDOS 1379		
ANFITRION	ESPACIO ESCENICO (TEATRO, MUSICA Y DANZA)	VENEZUELA 3340		
OESTE	ESPACIO ESCENICO (TEATRO, MUSICA Y DANZA)	BARCO CENTENERA DEL 141		
EL EXCENTRICO DE LA 18	ESPACIO ESCENICO (TEATRO, MUSICA Y DANZA)	LERMA 420		
VELMA CAFE	ESPACIO ESCENICO (TEATRO, MUSICA Y DANZA)	GORRITI 5520		
ENTRETELONES ESPACIO TEATRAL	ESPACIO ESCENICO (TEATRO, MUSICA Y DANZA)	MARTINEZ, ENRIQUE, GRAL. 1427		
EL BRIO	ESPACIO ESCENICO (TEATRO, MUSICA Y DANZA)	GUATEMALA 5092		
CENTRO CREATIVO CABILDO	ESPACIO ESCENICO (TEATRO, MUSICA Y DANZA)	CABILDO AV. 4740		
UNIVERSIDAD POPULAR DE BELGRANO ALFREDO FAZIO	BIBLIOTECA	CAMPOS SALLES 2145		
KORINTHIO TEATRO	ESPACIO ESCENICO (TEATRO, MUSICA Y DANZA)	JUNIN 380		
TEATRO EL ESPION	ESPACIO ESCENICO (TEATRO, MUSICA Y DANZA)	SARANDI 766		
EL GALPON MULTIESPACIO	ESPACIO ESCENICO (TEATRO, MUSICA Y DANZA)	DEAN FUNES 1267		
APACHETA	ESPACIO ESCENICO (TEATRO, MUSICA Y DANZA)	PASCO 623		
GRUPO MATEMURGA DE VILLA CRESPO	ESPACIO ESCENICO (TEATRO, MUSICA Y DANZA)	VIALE, LUIS 654		
MEDITERRANEA ESPACIO DE ARTE	ESPACIO ESCENICO (TEATRO, MUSICA Y DANZA)	TUCUMAN 3378		
DEL SUR	ESPACIO ESCENICO (TEATRO, MUSICA Y DANZA)	VENEZUELA 2255		
CINE PREMIER	CINE	CORRIENTES AV. 1565		
BROADWAY I  Y II	ESPACIO ESCENICO (TEATRO, MUSICA Y DANZA)	CORRIENTES AV. 1155		
ACTOR S STUDIO	ESPACIO ESCENICO (TEATRO, MUSICA Y DANZA)	DIAZ VELEZ AV. 3842		
DEL PASILLO	ESPACIO ESCENICO (TEATRO, MUSICA Y DANZA)	COLOMBRES 35		
TEATRO EL CUBO	ESPACIO ESCENICO (TEATRO, MUSICA Y DANZA)	ZELAYA 3053		
DEL NUDO	ESPACIO ESCENICO (TEATRO, MUSICA Y DANZA)	CORRIENTES AV. 1551		
BELISARIO CLUB DE CULTURA	ESPACIO ESCENICO (TEATRO, MUSICA Y DANZA)	CORRIENTES AV. 1624		
PICADILLY	ESPACIO ESCENICO (TEATRO, MUSICA Y DANZA)	CORRIENTES AV. 1524		
TEATRO EL BULULU	ESPACIO ESCENICO (TEATRO, MUSICA Y DANZA)	RIVADAVIA AV. 1350		
TEATRO LICEO	ESPACIO ESCENICO (TEATRO, MUSICA Y DANZA)	RIVADAVIA AV. 1495		
ARLEQUINO	ESPACIO ESCENICO (TEATRO, MUSICA Y DANZA)	ALSINA, ADOLFO 1484		
LOLA MEMBRIVES	ESPACIO ESCENICO (TEATRO, MUSICA Y DANZA)	CORRIENTES AV. 1280		
TEATRO EL VITRAL	ESPACIO ESCENICO (TEATRO, MUSICA Y DANZA)	RODRIGUEZ PE�A 344		
TST (TEATRO SAN TELMO)	ESPACIO ESCENICO (TEATRO, MUSICA Y DANZA)	COCHABAMBA 370		
EL CRISOL	ESPACIO ESCENICO (TEATRO, MUSICA Y DANZA)	ARISMENDI 2658		
CASTORERA	ESPACIO ESCENICO (TEATRO, MUSICA Y DANZA)	CORDOBA AV. 6237		
CLUB DE LAS ARTES	ESPACIO ESCENICO (TEATRO, MUSICA Y DANZA)	SALTA 755		
GARGANTUA	ESPACIO ESCENICO (TEATRO, MUSICA Y DANZA)	NEWBERY, JORGE AV. 3563		
GRUPO LOS VILLURQUEROS	ESPACIO ESCENICO (TEATRO, MUSICA Y DANZA)	MILLER 2751		
PUERTA ROJA	ESPACIO ESCENICO (TEATRO, MUSICA Y DANZA)	LAVALLE 3636		
ESCALADA	ESPACIO ESCENICO (TEATRO, MUSICA Y DANZA)	ESCALADA DE SAN MARTIN, R. 332		
LA RATONERA CULTURAL	ESPACIO ESCENICO (TEATRO, MUSICA Y DANZA)	CORRIENTES AV. 5552		
LA TERTULIA	ESPACIO ESCENICO (TEATRO, MUSICA Y DANZA)	GALLO 826		
EL BARDO	ESPACIO ESCENICO (TEATRO, MUSICA Y DANZA)	COCHABAMBA 743		
ND ATENEO	ESPACIO ESCENICO (TEATRO, MUSICA Y DANZA)	PARAGUAY 918		
TIMBRE 4	ESPACIO ESCENICO (TEATRO, MUSICA Y DANZA)	BOEDO AV. 640		
BIBLIOTECA POPULAR DR. ARTURO JAURETCHE	BIBLIOTECA	PERU 823		
BIBLIOTECA POPULAR ADOLFO SALDIAS	BIBLIOTECA	MONTEVIDEO 641		
BIBLIOTECA POPULAR CASA DE LA CULTURA DE LINIERS	BIBLIOTECA	PIERES 226		
BIBLIOTECA POPULAR MARIANO BOEDO	BIBLIOTECA	MAZA 755		
BIBLIOTECA POPULAR DR. ANTONIO SAENZ	BIBLIOTECA	SAENZ AV. 871		
BIBLIOTECA POPULAR JUAN PABLO ECHAGUE	BIBLIOTECA	SANTO TOME 2496		
BIBLIOTECA POPULAR EL PROGRESO	BIBLIOTECA	RIESTRA AV. 5655		
BIBLIOTECA POPULAR BERNARDINO RIVADAVIA	BIBLIOTECA	DIRECTORIO AV. 4623		
BIBLIOTECA POPULAR DR. TRISTAN J. GONZALEZ	BIBLIOTECA	GOYENA, PEDRO AV. 1579		
BIBLIOTECA POPULAR CORNELIO SAAVEDRA	BIBLIOTECA	GARCIA DEL RIO AV. 2735		
BIBLIOTECA POPULAR ALBERDI	BIBLIOTECA	ACEVEDO 666		
BIBLIOTECA POPULAR LIGA DE FOMENTO MITRE	BIBLIOTECA	GAVILAN 1540		
BIBLIOTECA POPULAR 12 DE OCTUBRE	BIBLIOTECA	ARENGREEN 1187		
BIBLIOTECA POPULAR FEDERICO LACROZE	BIBLIOTECA	THOMPSON 502		
CENTRO CULTURAL Y BIBLIOTECA POPULAR CARLOS SANCHEZ VIAMONTE	BIBLIOTECA	AUSTRIA 2156		
BIBLIOTECA POPULAR ROBERTO J. BENAMOR	BIBLIOTECA	BILLINGHURST 426		
BIBLIOTECA POPULAR HIJOS DEL BARRIO PIEDRA BUENA	BIBLIOTECA	2 DE ABRIL DE 1982 6730		
"MUSEO ""CASA DE YRURTIA"""	MUSEO	O'HIGGINS 2390		
MUSEO FOTOGRAFICO SIMIK	MUSEO	LACROZE, FEDERICO AV. 3901		
DEL PILAR - CLAUSTROS HISTORICOS	SALA DE EXPOSICION	JUNIN 1892		
BENITO QUINQUELA MARTIN. MUSEO DE BELLAS DE LA BOCA DE ARTISTAS ARGENTINOS	MUSEO	DON PEDRO DE MENDOZA AV. 1835		
CENTRO CULTURAL CARAS Y CARETAS	CENTRO CULTURAL	VENEZUELA 370		
JUAN BAUTISTA AMBROSETTI MUSEO ETNOGRAFICO	MUSEO	MORENO 350		
MUSEO DEL BICENTENARIO	MUSEO	PASEO COLON AV. 100		
DR. JOSE EVARISTO URIBURU - MUSEO HISTORICO Y NUMISMATICO DEL BANCO CENTRAL DE LA REPUBLICA ARGENTINA	MUSEO	SAN MARTIN 216		
"MUSEO DE CALCOS Y ESCULTURA COMPARADA ""ERNESTO DE LA CARCOVA"""	MUSEO	ESPAÃ‘A AV. 1701		
MUSEO CARLOS VEGA DEL INSTITUTO NACIONAL DE MUSEOLOGIA	MUSEO	MEXICO 546		
MUSEO HERMANO ESTEBAN LA SALLE	MUSEO	RIOBAMBA 650		
MUSEO VICENTE LOPEZ Y PLANES - SADAIC	MUSEO	LAVALLE 1547		
MUSEO ARGENTINO DEL TITERE	MUSEO	PIEDRAS 905		
MUSEO HISTORICO NACIONAL	MUSEO	DEFENSA 1600		
MARIA ANTONIA DE SAN JOSE MUSEO DE ARTE SACRO	MUSEO	INDEPENDENCIA AV. 1190		
INPB DR. MALBRAN MUSEO SERPENTARIO (CON FINES CIENTIFICOS)	MUSEO	VELEZ SARSFIELD AV. 563		
MUSEO JUDIO DE BUENOS AIRES	MUSEO	LIBERTAD 769		
MUSEO HISTORICO DE CERA	MUSEO	VALLE IBERLUCEA DEL, DR. 1261		
"MUSEO DE ARMAS DE LA NACION ""TENIENTE GENERAL PABLO RICCHIERI"""	MUSEO	SANTA FE AV. 702		
"MUSEO NACIONAL Y CENTRO DE ESTUDIOS HISTORICOS FERROVIARIOS ""RAUL SCALABRINI ORTIZ"""	MUSEO	DEL LIBERTADOR AV. 405		
MUSEO NACIONAL DE LA HISTORIA DEL TRAJE	MUSEO	CHILE 832		
MUSEO DEL AGUA Y DE LA HISTORIA SANITARIA	MUSEO	RIOBAMBA 750		
MUSEO NACIONAL DE BELLAS ARTES	MUSEO	DEL LIBERTADOR AV. 1473		
MUSEO HISTORICO DE GENDARMERIA NACIONAL	MUSEO	CASTILLO, RAMON S., PRES. AV. 788		
BUQUE MUSEO ARA CORBETA URUGUAY	MUSEO	MOREAU DE JUSTO, ALICIA AV. 500		
GALERIA DE ARTE KARINA PARADISO	GALERIA DE ARTE	DEL LIBERTADOR AV. 4700		
GALERIA DE ARTE ADRIANA INDIK	GALERIA DE ARTE	RODRIGUEZ PE�A 2067		
ALICIA BRANDY GALERIA DE ARTE	GALERIA DE ARTE	CHARCAS 3149		
APPETITE CONTEMPOPORARY ART	GALERIA DE ARTE	CHACABUCO 551		
GALERIA FOSTER CATENA	GALERIA DE ARTE	HONDURAS 4882		
DE SANTI GALERIA	GALERIA DE ARTE	ESMERALDA 952		
DE LA RECOLETA GALERIA DE ARTE	GALERIA DE ARTE	AGUERO 2502		
GALERIA EL SOCORRO	GALERIA DE ARTE	SUIPACHA 1331		
GALERIA RUBBERS INTERNACIONAL	GALERIA DE ARTE	ALVEAR 1595		
PALATINA GALERIA DE ARTE	GALERIA DE ARTE	ARROYO 821		
AGALMA.ARTE	GALERIA DE ARTE	ARROYO 882		
CONSORCIO DE ARTE DE BUENOS AIRES	GALERIA DE ARTE	GUIDO 1566		
GALERIA FORMA	GALERIA DE ARTE	THAMES 1620		
GALERIA ISIDRO MIRANDA	GALERIA DE ARTE	ESTADOS UNIDOS 726		
HOY EN EL ARTE GALERIA	GALERIA DE ARTE	JUNCAL 848		
GALERIA VAN RIEL	GALERIA DE ARTE	JUNCAL 790		
ZAVALETA LAB ARTE CONTEMPORANEO	GALERIA DE ARTE	VENEZUELA 571		
GALERIA ARTE X ARTE	GALERIA DE ARTE	LAVALLEJA 1062		
G/C ARTE CONTEMPORANEO	GALERIA DE ARTE	SUIPACHA 1250		
GACHI PIMIENTO GALLERY CONTEMPORARY LATIN AMERICA ART	GALERIA DE ARTE	URIARTE 1976		
TRANSARTE EMERGENCIAS CULTURALES	GALERIA DE ARTE	DEFENSA 1326		
GALERIA MAR DULCE	GALERIA DE ARTE	URIARTE 1490		
CENTOIRA	GALERIA DE ARTE	FRENCH 2611		
GALERIA PRAXIS	GALERIA DE ARTE	ARENALES 1311		
RO GALERIA DE ARTE	GALERIA DE ARTE	PARANA 1158		
GALERIA DABBAH TORREJON	GALERIA DE ARTE	EL SALVADOR 5176		
GALERIA 713 ARTE CONTEMPORANEO	GALERIA DE ARTE	DEFENSA 713		
GALERIA ELSI DEL RIO	GALERIA DE ARTE	HUMBOLDT 1510		
GALERIA VAN EYCK	GALERIA DE ARTE	SANTA FE AV. 834		
GALERIA VERMEER	GALERIA DE ARTE	SUIPACHA 1169		
GALERIA URSOMARZO	GALERIA DE ARTE	ARENALES 921		
GALERIA DE ARTE MERCEDES GIACHETTI	SALA DE EXPOSICION	DEFENSA 718		
GALERIA JORGE MARA  LA RUCHE	GALERIA DE ARTE	PARANA 1133		
GALERIA JACQUES MARTINEZ	GALERIA DE ARTE	DE MAYO AV. 1130		
BRAGA MENENDEZ ARTE CONTEMPORANEO	GALERIA DE ARTE	HUMBOLDT 1574		
SUBASTAS ROLDAN	GALERIA DE ARTE	JUNCAL 743		
FEDERICO TOWPYHA ARTE CONTEMPORANEO	GALERIA DE ARTE	TUCUMAN 3148		
GALERIA BACANO	GALERIA DE ARTE	ARMENIA 1544		
GALERIA IGNACIO LIPRANDI	GALERIA DE ARTE	DE MAYO AV. 1480		
GALERIA EDEA	GALERIA DE ARTE	DEFENSA 771		
GALERIA DANIEL MAMAN FINE ARTS	GALERIA DE ARTE	DEL LIBERTADOR AV. 2475		
GALERIA ZURBARAN	GALERIA DE ARTE	CERRITO 1522		
GALERIA WUSSMANN SAN TELMO	GALERIA DE ARTE	VENEZUELA 579		
GALERIA SARA GARCIA URIBURU	GALERIA DE ARTE	URUGUAY 1223		
SAAP - SOCIEDAD ARGENTINA DE ARTISTAS PLASTICOS	GALERIA DE ARTE	VIAMONTE 458		
GALERIA RUTH BENZACAR	GALERIA DE ARTE	FLORIDA 1000		
GALERIA VASARI	GALERIA DE ARTE	ESMERALDA 1357		
GALERIA LAURA HABER	GALERIA DE ARTE	JUNCAL 885		
GALERIA LAGARD	GALERIA DE ARTE	SUIPACHA 1216		
GALERIA ISABEL ANCHORENA	GALERIA DE ARTE	LIBERTAD 1389		
ESPACIO 10 ART GALLERY	GALERIA DE ARTE	GUATEMALA 4757		
ESPACIO FUNDACION TELEFONICA	SALA DE EXPOSICION	ARENALES 1540		
GALERIA ABATE	GALERIA DE ARTE	BOLLINI 2170		
GALERIA DEL INFINITO ARTE	GALERIA DE ARTE	QUINTANA, MANUEL, PRES. 325		
GALERIA ATICA	GALERIA DE ARTE	LIBERTAD 1240		
GALERIA BRAQUE	GALERIA DE ARTE	CHACABUCO 131		
GALERIA ARCIMBOLDO	SALA DE EXPOSICION	RECONQUISTA 761		
GALERIA RICARDO LOPEZ	GALERIA DE ARTE	ARENALES 966		
GALERIA DE ARTE MEDITERRANEA	GALERIA DE ARTE	PACHECO 2380		
GALERIA DE ARTE LEONARDO DA VINCI	GALERIA DE ARTE	LIBERTAD 1226		
GALERIA ALBERTO SENDROS	GALERIA DE ARTE	TRES SARGENTOS 359		
GALERIA MATILDE BENSIGNOR	GALERIA DE ARTE	MATIENZO, BENJAMIN, TENIENTE 2460		
CASA DE CASTAGNINO	GALERIA DE ARTE	BALCARCE 1016		
"MUSEO ARGENTINO DE CIENCIAS NATURALES ""BERNARDINO RIVADAVIA"""	MUSEO	GALLARDO, ANGEL AV. 490		
PALAIS DE GLACE - PALACIO NACIONAL DE LAS ARTES	SALA DE EXPOSICION	POSADAS 1795		
MUSEO DE LA DEUDA EXTERNA ARGENTINA	MUSEO	URIBURU JOSE E., PRES. 781		
MUSEO DE CIENCIA Y TECNICA FACULTAD DE INGENIERIA DE LA UNIVERSIDAD DE BS. AS.	MUSEO	LAS HERAS GENERAL AV. 2214		
MUSEO ERNESTO CHE GUEVARA	MUSEO	ROJAS 129		
MUSEO MONTE DE PIEDAD - BANCO CIUDAD DE BUENOS AIRES	MUSEO	BOEDO AV. 870		
COMPLEJO DE MUSEOS DEL INSTITUTO FELIX BERNASCONI	MUSEO	CASTILLO, CATULO 2750		
MUSEO DE LOS NIÑOS ABASTO	MUSEO	CORRIENTES AV. 3247		
MUSEO DE LA PASION BOQUENSE	MUSEO	BRANDSEN 805		
MUSEO INTERACTIVO DE MATEMATICA - MATEUBA MUSEUM	MUSEO	GUIRALDES, INT. 2620		
"MUSEO DE MINERALOGIA ""DOCTORA E. MERTOLA"""	MUSEO	GUIRALDES, INT. 2620		
MUSEO EVITA. INSTITUTO NACIONAL DE INVESTIGACIONES HISTORICAS EVA PERON.	MUSEO	LAFINUR 2988		
TALLER MUSEO GYULA KOSICE	MUSEO	HUMAHUACA 4662		
MUSEO HISTORICO Y NUMISMATICO DEL BANCO DE LA NACION ARGENTINA	MUSEO	MITRE, BARTOLOME 326		
MUSEO DE LA ASOCIACION DE ANESTESIA, ANALGESIA Y REANIMACION	MUSEO	FRAGATA PRES. SARMIENTO 541		
MUSEO DEL HOMBRE. INSTITUTO DE ANTROPOLOGIA Y PENSAMIENTO LATINOAMERICANO.	MUSEO	3 DE FEBRERO 1370		
MUSEO HISTORICO NACIONAL DEL CABILDO Y DE LA REVOLUCION DE MAYO	MUSEO	BOLIVIA 65		
MUSEO DE LA ADMINISTRACION FEDERAL DE INGRESOS PUBLICOS (AFIP)	MUSEO	YRIGOYEN, HIPOLITO AV. 370		
MUSEO NACIONAL DEL GRABADO	MUSEO	AGUERO 2502		
FUNDACION FEDERICO JORGE KLEMM	SALA DE EXPOSICION	ALVEAR, MARCELO T. DE 626		
FUNDACION ALBERTO ELIA MARIO ROBIROSA	GALERIA DE ARTE	AZCUENAGA 1739		
FUNDACION PROA	SALA DE EXPOSICION	DON PEDRO DE MENDOZA AV. 1929		
MUSEO DE LA POLICIA FEDERAL ARGENTINA	MUSEO	SAN MARTIN 353		
MUSEO MITRE	MUSEO	SAN MARTIN 336		
MUSEO CRIOLLO DE LOS CORRALES	MUSEO	DE LOS CORRALES AV. 6501		
MUSEO HISTORICO SARMIENTO	MUSEO	JURAMENTO AV. 2180		
MUSEO NACIONAL DE ARTE DECORATIVO	MUSEO	DEL LIBERTADOR AV. 1902		
MUSEO ROCA INSTITUTO DE INVESTIGACIONES HISTORICAS	MUSEO	LOPEZ, VICENTE 2220		
"MUSEO PARTICIPATIVO DE CIENCIAS ""PROHIBIDO NO TOCAR"""	MUSEO	JUNIN 1939		
MUSEO DEL HOLOCAUSTO DE BUENOS AIRES - SHOA MUSEUM	MUSEO	MONTEVIDEO 919		
MUSEO XUL SOLAR	MUSEO	LAPRIDA 1212		
"MUSEO DEL SENADO DE LA NACION ARGENTINA ""SENADOR DOMINGO FAUSTINO SARMIENTO"""	MUSEO	YRIGOYEN, HIPOLITO AV. 1708		
"MUSEO DE LA FARMACIA ""DRA. ROSA DALESSIO DE CARNEVALE BONINO"""	MUSEO	JUNIN 956		
"MUSEO DE FARMACO BOTANICA ""JUAN A. DOMINGUEZ"""	MUSEO	JUNIN 956		
CENTRO ANA FRANK ARGENTINA	MUSEO	SUPERI 2647		
MUSEO CASA TALLER CELIA CHEVALIER	MUSEO	IRALA 1162		
MUSEO FRANCISCANO JOSE MARIA BOTARO	MUSEO	ALSINA, ADOLFO 380		
BUQUE MUSEO FRAGATA ARA PRESIDENTE SARMIENTO	MUSEO	MOREAU DE JUSTO, ALICIA AV. 980		
INSTITUTO DE INVESTIGACIONES HISTORICAS DE LAS MANZANAS DE LAS LUCES	MUSEO	PERU 272		
MUSEO MUNDIAL DEL TANGO DE LA ACADEMIA NACIONAL DEL TANGO	MUSEO	RIVADAVIA AV. 830		
MUSEO PARTICIPATIVO MINERO MUMIN	MUSEO	ROCA, JULIO A., PRESIDENTE AV. 651		
MUSEO DEL AUDIFONO	MUSEO	PERON, JUAN DOMINGO, TTE. GENERAL 1647		
MUSEO DE LOS PATRICIOS DE BUENOS AYRES - REGIMIENTO DE INFANTERIA NRO 1	MUSEO	BULLRICH, INT. AV. 481		
MUSEO DE ARQUITECTURA Y DISEÑO MARQ	MUSEO	DEL LIBERTADOR AV. 999		
MUSEO CASA DE RICARDO ROJAS	MUSEO	CHARCAS 2837		
CLUB GRICEL	MILONGA Y/O TANGUERIA	LA RIOJA 1180		
COMPLEJO TANGO	MILONGA Y/O TANGUERIA	BELGRANO AV. 2608		
CANDILEJAS TANGO	MILONGA Y/O TANGUERIA	ESTADOS UNIDOS 1500		
ROJO TANGO	MILONGA Y/O TANGUERIA	SALOTTI MARTHA 445		
LA VENTANA	MILONGA Y/O TANGUERIA	BALCARCE 431		
GALA TANGO	MILONGA Y/O TANGUERIA	5 DE JULIO 434		
SABOR A TANGO	MILONGA Y/O TANGUERIA	PERON, JUAN DOMINGO, TTE. GENERAL 2535		
MADERO TANGO	MILONGA Y/O TANGUERIA	MOREAU DE JUSTO, ALICIA AV. 2060		
LA PAILA RESTAURANT	PEÑA	COSTA RICA 4848		
BIBLIOTECA ANTARTIDA	BIBLIOTECA	CERRITO 1248		
"BIBLIOTECA DE SEGURIDAD SOCIAL ""DR. RICARDO MOLES"""	BIBLIOTECA	BALCARCE 610		
CENTRO DE INFORMACION TECHINT	BIBLIOTECA	CORDOBA AV. 320		
BIBLIOTECA FUNDACION DE ALTOS ESTUDIOS EN CIENCIAS COMERCIALES	BIBLIOTECA	URUGUAY 57		
BIBLIOTECA CENTRO DE ESTUDIOS PARA LA NUEVA MAYORIA	BIBLIOTECA	ESTADOS UNIDOS 943		
"SERVICIO DE INFORMACION Y DOCUMENTACION DEL HOSPITAL NACIONAL DE PEDIATRIA ""PROF. JUAN P. GARRAHAN"""	BIBLIOTECA	COMBATE DE LOS POZOS 1881		
"BIBLIOTECA ""BIALET MASSE"""	BIBLIOTECA	ALEM, LEANDRO N. AV. 650		
BIBLIOTECA CENTRO DE ESTUDIOS DE POBLACION	BIBLIOTECA	CORRIENTES AV. 2817		
BIBLIOTECA FUNDACION DE ESTUDIOS BRASILEIROS. LIBRERIA FLOR DO IPE	BIBLIOTECA	ESMERALDA 965		
BIBLIOTECA NACIONAL DE MAESTROS	BIBLIOTECA	PIZZURNO 953		
HEMEROTECA DEL MINISTERIO DE EDUCACION	ARCHIVO	PIZZURNO 953		
CENTRO DE INFORMACION Y DOCUMENTACION EDUCATIVA	ARCHIVO	PIZZURNO 935		
BIBLIOTECA AUDITORIA GENERAL DE LA NACION	BIBLIOTECA	YRIGOYEN, HIPOLITO 1236		
BIBLIOTECA DE LA SUPERINTENDENCIA DE RIESGOS DEL TRABAJO	BIBLIOTECA	MITRE, BARTOLOME 751		
"CENTRO DE DOCUMENTACION DEL CENTRO FEDERAL DE INVERSIONES CFI ""DR. MANUEL BELGRANO"""	BIBLIOTECA	SAN MARTIN 871		
BIBLIOTECA Y CENTRO ADMNISTRATIVO DOCUMENTAL SEDRONAR	BIBLIOTECA	SARMIENTO 546		
"BIBLIOTECA CENTRAL Y CENTRO DE DOCUMENTACION ""PERITO FRANCISCO P. MORENO"""	BIBLIOTECA	SANTA FE AV. 690		
BIBLIOTECA DEL SERVICIO DE HIDROGRAFIA NAVAL	BIBLIOTECA	MONTES DE OCA, MANUEL 2124		
"BIBLIOTECA Y SERVICIO DE INFORMACION EN LINEA ""DR. CARLOS A. DURRUTY"""	BIBLIOTECA	SANCHEZ DE BUSTAMANTE 1749		
BIBLIOTECA DEL INSTITUTO ARGENTINO DEL ENVASE	BIBLIOTECA	JUJUY AV. 425		
CENTRO INTERDISCIPLINARIO DE INVESTIGACIONES EN PSICOLOGIA, MATEMATICA Y EXPERIMENTAL	BIBLIOTECA	PERON, JUAN DOMINGO, TTE. GENERAL 2158		
CENTRO DE INVESTIGACIONES ENDOCRINOLOGICAS CEDIE	BIBLIOTECA	GALLO 1330		
BIBLIOTECA DEL INSTITUTO UNIVERSITARIO DE LA POLICIA FEDERAL ARGENTINA	BIBLIOTECA	ROSARIO 532		
"BIBLIOTECA DEL INSTITUTO TECNICO MEDICO ""ALEXADER FLEMING"". FUNDACION CANCER (FUCA)."	BIBLIOTECA	CRAMER 1180		
BIBLIOTECA DEL INSTITUTO SUPERIOR EN LENGUAS VIVAS	BIBLIOTECA	PELLEGRINI, CARLOS 1515		
BIBLIOTECA DEL AREA DE INVESTIGACIONES GEOGRAFICAS DEL INSTITUTO MULTIDISCIPLINARIO DE CIENCIAS HUMANAS	BIBLIOTECA	SAAVEDRA 15		
BIBLIOTECA DEL AREA DE ARQUEOLOGIA DEL INSTITUTO MULTIDISCIPLINARIO DE CIENCIAS HUMANAS	BIBLIOTECA	SAAVEDRA 15		
BIBLIOTECA DEL AREA DE EGIPTOLOGIA DEL INSTITUTO MULTIUDISCIPLINARIO DE CIENCIAS HUMANAS	BIBLIOTECA	SAAVEDRA 15		
BIBLIOTECA DEL AREA DE INVESTIGACIONES MEDIEVALES DEL INSTITUTO MULTIDISCIPLINARIO DE CIENCIAS HUMANAS	BIBLIOTECA	SAAVEDRA 15		
BIBLIOTECA DE LA ESCUELA DE LA ORIENTACION LACANIANA	BIBLIOTECA	CALLAO AV. 1033		
BIBLIOTECA DE LA SOCIEDAD ARGENTINA DE CARDIOLOGIA	BIBLIOTECA	AZCUENAGA 980		
BIBLIOTECA DE LA UNIVERSIDAD DE BELGRANO	BIBLIOTECA	ZABALA 1851		
BIBLIOTECA DE LA ACADEMIA NACIONAL DE CIENCIAS EXACTAS, FISICAS Y NATURALES	BIBLIOTECA	ALVEAR 1711		
"BIBLIOTECA DE LA ASOCIACION DE BIBLIOTECARIOS GRADUADOS DE LA REPUBLICA ARGENTINA ""REINALDO JOSE SUAREZ"""	BIBLIOTECA	PARANA 918		
BIBLIOTECA DE LA FACULTAD DE DERECHO DE LA UBA	BIBLIOTECA	FIGUEROA ALCORTA, PRES. AV. 2263		
BIBLIOTECA NACIONAL	BIBLIOTECA	AGUERO 2502		
BIBLIOTECA DE LA SOCIEDAD ARGENTINA DE REUMATOLOGIA	BIBLIOTECA	CALLAO AV. 384		
BIBLIOTECA DEL INSTITUTO NACIONAL DE TECNOLOGIA AGROPECUARIA - INSTITUTO DE ECONOMIA Y SOCIOLOGIA	BIBLIOTECA	CERVIÃ‘O AV. 3101		
BIBLIOTECA DEL MUSEO NACIONAL DE ARTE DECORATIVO	BIBLIOTECA	DEL LIBERTADOR AV. 1902		
BIBLIOTECA DEL CENTRO DE INVESTIGACIONES FILOSOFICAS CIF	BIBLIOTECA	MIÃ‘ONES 2073		
INSTITUTO DE GEOCRONOLOGIA Y GEOLOGIA ISOTOPICA	BIBLIOTECA	GUIRALDES, INT. 2620		
INSTITUTO NACIONAL SAN MARTINIANO	BIBLIOTECA	CASTILLA, RAMON, MARISCAL Y AGUADO, ALEJANDRO M. DE		
INSTITUTO DE BIOLOGIA Y MEDICINA EXPERIMENTAL	BIBLIOTECA	VUELTA DE OBLIGADO 2490		
"INSTITUTO NACIONAL DE ANTROPOLOGIA Y PENSAMIENTO LATINOAMERICA - BIBLIOTECA Y CENTRO DE DOCUMENTACION ""JUAN ANTONIO CARRIZO"""	BIBLIOTECA	3 DE FEBRERO 1378		
BIBLIOTECA CENTRAL DE CIUDAD UNIVERSITARIA (UBA)	BIBLIOTECA	GUIRALDES, INT. 2620		
"BIBLIOTECA DEL INSTITUTO ARGENTINO DE MATEMATICA ""ALBERTO CALDERON"""	BIBLIOTECA	SAAVEDRA 15		
BIBLIOTECA DEL CENTRO ARGENTINO DE INFORMACION CIENTIFICA Y TECNOLOGICA	BIBLIOTECA	SAAVEDRA 15		
RED DE BIBLIOTECAS UNIVERSITARIAS DEL SALVADOR RED BUS	BIBLIOTECA	PERON, JUAN DOMINGO, TTE. GENERAL 1818		
"BIBLIOTECA ALVEAR ""R.P. ERNESTO DANN OBREGON S.J"" UNIVERSIDAD DEL SALVADOR"	BIBLIOTECA	ALVEAR, MARCELO T. DE 1312		
"BIBLIOTECA ""FINOCHIETTO"" DE LA FACULTAD DE MEDICINA UNIVERSIDAD DEL SALVADOR"	BIBLIOTECA	TUCUMAN 1845		
BIBLIOTECA DEL HOSPITAL MATERNO INFANTIL RAMON SARDA	BIBLIOTECA	LUCA, ESTEBAN DE 2151		
"BIBLIOTECA ""DR. MARTIN VAZQUEZ VIGO"" DE LA ASOCIACION MEDICOS MUNICIPALES DE LA CIUDAD DE BS.AS."	BIBLIOTECA	PACHECO DE MELO, JOSE ANDRES 2034		
BIBLIOTECA DEL CENTRO DE ECONOMIA INTERNACIONAL (CEI)	BIBLIOTECA	ESMERALDA 1212		
BIBLIOTECA NACIONAL DE METEOROLOGIA ?ING. ALFREDO G. GALMARINI?	BIBLIOTECA	25 DE MAYO 658		
BIBLIOTECA CENTRAL DE UNIVERSIDAD ABIERTA INTERAMERICANA	BIBLIOTECA	MONTES DE OCA, MANUEL 745		
BIBLIOTECA UNIVERSITARIA DEL CINE	BIBLIOTECA	GIUFFRA, JOSE M.,DR. 330		
CENTRO DOCUMENTAL Y BIBLIOTECA DEL ATENEO ARGENTINO DE ODONTOLOGIA	BIBLIOTECA	ANCHORENA, TOMAS MANUEL DE, DR. 1176		
BIBLIOTECA CENTRAL DE LA UNIVERSIDAD AUSTRAL	BIBLIOTECA	GARAY, JUAN DE AV. 125		
"BIBLIOTECA ""DR. CARLOS CARDINI"" DE LA FUNDACION INSTITUTO LELOIR"	BIBLIOTECA	PATRICIAS ARGENTINAS AV. 435		
"BIBLIOTECA ""UTOPIA"" DEL CENTRO CULTURAL DE LA COOPERACION"	BIBLIOTECA	CORRIENTES AV. 1543		
BIBLIOTECA UNIVERSITARIA MAIMONIDES	BIBLIOTECA	HIDALGO 775		
BIBLIOTECA Y ARCHIVO DOCUMENTAL DEL INSTITUTO NACIONAL DE TECNOLOGIA AGROPECUARIA (INTA)	BIBLIOTECA	CHILE 460		
"BIBLIOTECA ""EZEQUIEL MARTINEZ ESTRADA"" DE LA UNIVERSIDAD FAVALORO"	BIBLIOTECA	BELGRANO AV. 1720		
BIBLIOTECA Y CENTRO MULTIMEDIA DE LA FACULTAD DE CIENCIAS VETERINARIAS UBA	BIBLIOTECA	CHORROARIN AV. 280		
BIBLIOTECA DEL ALMA MATER STUDIORUM UNIVERSIDAD DI BOLOGNA	BIBLIOTECA	RODRIGUEZ PE�A 1464		
"BIBLIOTECA ""PROFESOR EMERITO DR. ALFREDO L. PALACIOS"""	BIBLIOTECA	CORDOBA AV. 2122		
BIBLIOTECA BARTOLOME MITRE COLEGIO PUBLICO DE TRADUCTORES	BIBLIOTECA	CORRIENTES AV. 1834		
CENTRO LATINOAMERICANO DE DOCUMENTACION INFORMATICA Y ELECTRONICA	BIBLIOTECA	URUGUAY 252		
BIBLIOTECA DEL COLEGIO DE ABOGADOS DE LA CIUDAD DE BUENOS AIRES	BIBLIOTECA	MONTEVIDEO 640		
ARCHIVO TECNICO DE LA SECRETARIA DE ENERGIA	BIBLIOTECA	PASEO COLON AV. 171		
BIBLIOTECA DE LA COMISION NACIONAL DE COMERCIO EXTERIOR	BIBLIOTECA	PASEO COLON AV. 275		
"BIBLIOTECA DE DEFENSA ""GENERALA JUANA AZURDUY"""	BIBLIOTECA	AZOPARDO Y MORENO		
ARCHIVO GENERAL DE LA NACION - ARCHIVO INTERMEDIO	ARCHIVO	PASEO COLON AV. 1093		
CENTRO BIBLIOGRAFICO DE ENFERMEDADES ENDEMICAS	BIBLIOTECA	PASEO COLON AV. 568		
INSTITUTO NACIONAL DE ALIMENTOS	ARCHIVO	ESTADOS UNIDOS 25		
"BIBLIOTECA LABORATORIOS ALCON ""CARLOS S. DAMEL"""	BIBLIOTECA	PERON, JUAN DOMINGO, TTE. GENERAL 1479		
CENTRO DE INFORMACION Y DOCUMENTACION EN ONCOLOGIA	ARCHIVO	TUCUMAN 731		
BIBLIOTECA ESCUELA SUPERIOR DE GUERRA AEREA	BIBLIOTECA	ZANNI PEDRO COMODORO 250		
BIBLIOTECA MARISEL MONTOTO RODRIGUEZ	BIBLIOTECA	DE MAYO AV. 866		
BIBLIOTECA DE LA UNION INDUSTRIAL ARGENTINA	ARCHIVO	DE MAYO AV. 1147		
UNIVERSIDAD DEL CEMA ADRIAN GUISARRI	BIBLIOTECA	CORDOBA AV. 400		
BIBLIOTECA DR. LAUREANO RIVAS MIGUEZ DEL HOSPITAL DE NIÑOS RICARDO GUTIERREZ	BIBLIOTECA	GALLO 1330		
SOCIEDAD ARGENTINA DE ORTODONCIA	BIBLIOTECA	MONTEVIDEO 971		
"FUNDACION ""DR. HECTOR BARCELO"""	BIBLIOTECA	LAS HERAS GENERAL AV. 2191		
BIBLIOTECA JOSE MURTHAG	BIBLIOTECA	DIAZ, CNEL. AV. 1971		
BIBLIOTECA DEL COLEGIO NACIONAL BUENOS AIRES	BIBLIOTECA	BOLIVAR 263		
INSTITUTO DE INVESTIGACIONES JURIDICAS Y SOCIALES AMBROSIO L. GIOJA	BIBLIOTECA	FIGUEROA ALCORTA, PRES. AV. 2263		
"BIBLIOTECA CENTRAL ""DR. LUIS F. LELOIR"""	BIBLIOTECA	GUIRALDES, INT. 2620		
BIBLIOTECA CENTRAL DE LA FACULTAD DE AGRONOMIA (UBA)	BIBLIOTECA	SAN MARTIN AV. 4453		
BIBLIOTECA CENTRAL DEL ESTADO MAYOR CONJUNTO DE LAS FUERZAS ARMADAS	BIBLIOTECA	PASEO COLON AV. 255		
BIBLIOTECA DEL INSTITUTO NACIONAL DE LA PROPIEDAD INDUSTRIAL (I.N.P.I.)	BIBLIOTECA	PASEO COLON AV. 717		
"CENTRO DE DOCUMENTACION E INFORMACION ""DR. JORGE EDUARDO COLL"""	BIBLIOTECA	PERON, JUAN DOMINGO, TTE. GENERAL 524		
PEÑA DE TANGO ALMA DE BOHEMIO DEL CLUB SOCIAL BOHEMIO	MILONGA Y/O TANGUERIA	NECOCHEA 948		
MILONGA NUEVO SALON ARGENTINA	MILONGA Y/O TANGUERIA	MITRE, BARTOLOME 1759		
MILONGA PARAKULTURAL	MILONGA Y/O TANGUERIA	SCALABRINI ORTIZ, RAUL AV. 1331		
CIRCULO TROVADOR	MILONGA Y/O TANGUERIA	DEL LIBERTADOR AV. 1031		
MILONGA GAY LA MARSHALL	MILONGA Y/O TANGUERIA	RIOBAMBA 416		
EL BESO	MILONGA Y/O TANGUERIA	RIOBAMBA 416		
BOEDO TANGO	MILONGA Y/O TANGUERIA	SAN JUAN AV. 3330		
CLUB PIAMONTES - SALON RODRIGUEZ	MILONGA Y/O TANGUERIA	RODRIGUEZ, MANUEL A., GENERAL 1191		
CLUB CRISOL UNIDOS - MILONGA SARAZA TANGO	MILONGA Y/O TANGUERIA	SARAZA 951		
SOCIEDAD DE FOMENTO MARIANO ACOSTA - MILONGA LA TIERRITA	MILONGA Y/O TANGUERIA	ACOSTA, MARIANO 1544		
CLUB SUNDERLAND - LA MILONGA DEL MUNDO	MILONGA Y/O TANGUERIA	LUGONES 3161		
ESQUINA CARLOS GARDEL	MILONGA Y/O TANGUERIA	GARDEL, CARLOS 3200		
EL VIEJO ALMACEN	MILONGA Y/O TANGUERIA	INDEPENDENCIA AV. 303		
MILONGA EL ARRANQUE	MILONGA Y/O TANGUERIA	MITRE, BARTOLOME 1759		
GRUPO DE TEATRO ALMA MATE DE FEORES	ESPACIO ESCENICO (TEATRO, MUSICA Y DANZA)	NAZCA AV. Y NEUQUEN		
CASAL DE CATALUNYA	ESPACIO ESCENICO (TEATRO, MUSICA Y DANZA)	CHACABUCO 863		
EL TEATRO DE FLORES	ESPACIO ESCENICO (TEATRO, MUSICA Y DANZA)	RIVERA INDARTE AV. 129		
CLUB DE AMIGOS DE LA VACA PROFANA	ESPACIO ESCENICO (TEATRO, MUSICA Y DANZA)	LAVALLE 3683		
CLUB DE TRAPECISTAS	ESPACIO ESCENICO (TEATRO, MUSICA Y DANZA)	FERRARI 252		
TEATRO DEL GLOBO	ESPACIO ESCENICO (TEATRO, MUSICA Y DANZA)	ALVEAR, MARCELO T. DE 1155		
YUPANQUI	ESPACIO ESCENICO (TEATRO, MUSICA Y DANZA)	GUAMINI 4512		
SALA LA NAZCA	ESPACIO ESCENICO (TEATRO, MUSICA Y DANZA)	NAZCA AV. 1000		
BARTOLOMEO	ESPACIO ESCENICO (TEATRO, MUSICA Y DANZA)	MITRE, BARTOLOME 1525		
FRAY MOCHO	ESPACIO ESCENICO (TEATRO, MUSICA Y DANZA)	PERON, JUAN DOMINGO, TTE. GENERAL 3644		
ESPACIO AGUIRRE	ESPACIO ESCENICO (TEATRO, MUSICA Y DANZA)	AGUIRRE 1270		
ESPACIO CULTURAL URBANO	ESPACIO ESCENICO (TEATRO, MUSICA Y DANZA)	ACEVEDO 460		
VERA VERA TEATRO	ESPACIO ESCENICO (TEATRO, MUSICA Y DANZA)	VERA 108		
ESPACIO INCAA KM2 LA MASCARA	CINE	PIEDRAS 736		
CINE LORCA	CINE	CORRIENTES AV. 1420		
ARTE CINEMA ESPACIO INCAA KM3	CINE	SALTA 1620		
CINEMA CITY GENERAL PAZ	CINE	CABILDO AV. 2702		
ESPACIO INCAA KM 0 - GAUMONT	CINE	RIVADAVIA AV. 1635		
"MUSEO DE LA HISTORIA DE LA MEDICINA ""VICENTE ANIBAL"""	MUSEO	URIBURU JOSE E., PRES. 949		
MAGUNCIA. MUSEO DEL PAPEL, GRABADO Y ESTAMPA.	MUSEO	DON PEDRO DE MENDOZA AV. 1855		
MUSEO HISTORICO Y DE LAS TRADICIONES POPULARES DE LA BOCA	MUSEO	DON PEDRO DE MENDOZA AV. 1727		
"MUSEO GEOGRAFICO Y MUSEO DE CIENCIAS NATURALES ""DR. JUAN B. TERAN Y ""DR. ANGEL GALLARDO"""	MUSEO	CATAMARCA 2099		
"MUSEO ""GENERAL BELGRANO"""	MUSEO	SARACHAGA 4906		
BAR, PELUQUERIA Y BARBERIA LA EPOCA	BAR CULTURAL	GUAYAQUIL 877		
BAR VIRASORO	ESPACIO ESCENICO (TEATRO, MUSICA Y DANZA)	GUATEMALA 4328		
BUKOWSKI BAR	BAR CULTURAL	MITRE, BARTOLOME 1525		
LIBRERIA CRACK UP	LIBRERIA	COSTA RICA 4767		
GALERIA ARROYO	GALERIA DE ARTE	ARROYO 830		
LA ESQUINA DE ANIBAL TROILO	BAR CULTURAL	PARAGUAY 1500		
BAR CAFE LA DAMA DE BOLLINI	ESPACIO ESCENICO (TEATRO, MUSICA Y DANZA)	BOLLINI 2281		
LA VIRUTA TANGO	MILONGA Y/O TANGUERIA	ARMENIA 1366		
GALERIA PABELLON 4	GALERIA DE ARTE	URIARTE 1332		
CAFE LITERARIO OSVALDO BAYER	BAR CULTURAL	YRIGOYEN, HIPOLITO 1440		
CENTRO CULTURAL CASA CABRERA	CENTRO CULTURAL	CABRERA, JOSE A. 3653		
CENTRO CULTURAL BARRIAL GENESIS	CENTRO CULTURAL	IBERA 6085		
CENTRO CULTURAL BORGES	CENTRO CULTURAL	VIAMONTE 525		
CENTRO CULTURAL DE LA COOPERACION FLOREAL GORINI	CENTRO CULTURAL	CORRIENTES AV. 1543		
ESPACIO CULTURAL POMPAPETRIYAZOS	ESPACIO ESCENICO (TEATRO, MUSICA Y DANZA)	BRASIL 2800		
CASA DEL NIÑO Y EL ADOLESCENTE	ESPACIO DE FORMACION (CARRERAS, SEMINARIOS Y TALLERES)	JANER, ANA MARIA Y VEDIA, AGUSTIN DE		
BIBLIOTECA DE LA CAMARA ARGENTINA DE LA INDUSTRIA PLASTICA	BIBLIOTECA	SALGUERO, JERONIMO 1939		
PEÑA LOS CARDONES	PEÑA	BORGES, JORGE LUIS 2180		
PEÑA LA BAGUALA	PEÑA	BROWN, ALTE. AV. 736		
LA CUMPARCITA TANGO BAR	MILONGA Y/O TANGUERIA	CHILE AV. 302		
SEÑOR TANGO	MILONGA Y/O TANGUERIA	VIEYTES 1655		
PORTEÑO Y BAILARIN	MILONGA Y/O TANGUERIA	RIOBAMBA 345		
CLUB FULGOR DE VILLA CRESPO - PRAKTIKA8 - MILONGA10	MILONGA Y/O TANGUERIA	LOYOLA 828		
BIBLIOTECA DEL GOETHE INSTITUTO BUENOS AIRES	BIBLIOTECA	CORRIENTES AV. 343		
"BIBLIOTECA ""EMILIO FRES"" DE LA UNIVERSIDAD MUSEO SOCIAL ARGENTINO"	BIBLIOTECA	CORRIENTES AV. 1723		
CINE MONUMENTAL LAVALLE	CINE	LAVALLE 780		
ATLAS PATIO BULLRICH	CINE	DEL LIBERTADOR AV. 750		
CINEMA DEVOTO	CINE	VARELA, JOSE PEDRO 4866		
BAR KAFKA	BAR CULTURAL	PARAGUAY 1846		
CINE COSMOS (UBA)	CINE	CORRIENTES AV. 2046		
ASTROBAR	BAR CULTURAL	MEDRANO AV. 950		
ATLAS FLORES	CINE	RIVERA INDARTE AV. 44		
CENTRO CULTURAL E INFORMATIVO DE LA EMBAJADA DE JAPON	CENTRO CULTURAL	PARAGUAY 1127		
CENTRO CULTURAL DE ESPAÑA EN BUENOS AIRES	CENTRO CULTURAL	FLORIDA 493		
CIRCUITO CULTURAL BARRACAS	ESPACIO ESCENICO (TEATRO, MUSICA Y DANZA)	IRIARTE, GRAL. AV. 2165		
ALIANZA FRANCESA DE BUENOS AIRES (SEDE CORDOBA)	CENTRO CULTURAL	CORDOBA AV. 936		
ASOCIACION DANTE ALIGHIERI DE BUENOS AIRES (SEDE TUCUMAN)	CENTRO CULTURAL	TUCUMAN 1646		
CENTRO CULTURAL ERNESTO SABATO	CENTRO CULTURAL	URIBURU JOSE E., PRES. 763		
BRITISH ART CENTRE	CENTRO CULTURAL	SUIPACHA 1333		
ESPACIO CULTURAL EMBAJADA DEL BRASIL	CENTRO CULTURAL	ARROYO 1142		
CENTRO CULTURAL AGRONOMIA	CENTRO CULTURAL	SAN MARTIN AV. 4453		
EL COLECTIVO ARTE EN MOVIMIENTO	CENTRO CULTURAL	IBERA 4836		
ALIANZA FRANCESA DE BUENOS AIRES (SEDE GRANADEROS)	CENTRO CULTURAL	GRANADEROS 61		
EL TUNEL CENTRO CULTURAL	CENTRO CULTURAL	BONPLAND 2050		
ALIANZA FRANCESA DE BUENOS AIRES (SEDE 11 DE SETIEMBRE)	CENTRO CULTURAL	11 DE SEPTIEMBRE DE 1888 950		
CENTRO CULTURAL DEL ESQUINAZO	CENTRO CULTURAL	PERON, JUAN DOMINGO, TTE. GENERAL 1785		
ASOCIACION DANTE ALIGHIERI DE BUENOS AIRES (SEDE CABILDO)	CENTRO CULTURAL	CABILDO AV. 2772		
CENTRO CULTURAL COREANO	CENTRO CULTURAL	DIAZ, CNEL. AV. 2884		
CASA NACIONAL DEL BICENTENARIO	CENTRO CULTURAL	RIOBAMBA 985		
CIUDAD CULTURAL KONEX	CENTRO CULTURAL	SARMIENTO 3131		
CENTRO CULTURAL ISLAMICO	CENTRO CULTURAL	BULLRICH, INT. AV. 55		
CENTRO CULTURAL ENRIQUE SANTOS DISCEPOLO	CENTRO CULTURAL	RIVAROLA, RODOLFO, DR. 154		
CENTRO CULTURAL JOSE INGENIEROS	CENTRO CULTURAL	PARAGUAY 2155		
ESPACIO SOCIAL Y CULTURAL COMUNARTE	CENTRO CULTURAL	CASTRO BARROS AV. 236		
CENTRO CULTURAL EL SURCO	CENTRO CULTURAL	BOEDO AV. 830		
ASOCIACION DANTE ALIGHIERI DE BUENOS AIRES (SEDE COMODORO MARTIN RIVADAVIA)	CENTRO CULTURAL	RIVADAVIA AV. 6460		
CENTRO CULTURAL MARTIN FIERRO	CENTRO CULTURAL	CHORROARIN AV. 280		
"CENTRO CULTURAL ""FRANCISCO PACO URONDO"""	CENTRO CULTURAL	25 DE MAYO 221		
CENTRO CULTURAL FACULTAD DE FILOSOFIA Y LETRAS DE LA PONTIFICIA UNIVERSIDAD CATOLICA	CENTRO CULTURAL	MOREAU DE JUSTO, ALICIA AV. 1500		
ASOCIACION DANTE ALIGHIERI DE BUENOS AIRES (SEDE MONTES DE OCA)	CENTRO CULTURAL	MONTES DE OCA, MANUEL 501		
CASA DE LA CULTURA LOS COMPADRES DEL HORIZONTE	CENTRO CULTURAL	COMBATE DE LOS POZOS 1936		
CENTRO CULTURAL EL QUIJOTERO	CENTRO CULTURAL	FIGUEROA, D. APOLINARIO, CORONEL 936		
CASA POPULAR VIENTOS DEL PUEBLO	CENTRO CULTURAL	IRIGOYEN 2587		
CENTRO CULTURAL EL QUIJOTE	CENTRO CULTURAL	ARAOZ 176		
CENTRO CULTURAL EL SURCO DE MATADEROS	CENTRO CULTURAL	OLIDEN 1440		
GRUPO DE TEATRO COMUNITARIO DE POMPEYA	CENTRO CULTURAL	TABARE 1299		
EL CORRALON DE FLORESTA	CENTRO CULTURAL	GAONA AV. 4660		
CENTRO CULTURAL ASOCIACION MUTUAL HOMERO MANZI	CENTRO CULTURAL	BELGRANO AV. 3540		
CENTRO CULTURAL RICARDO ROJAS	CENTRO CULTURAL	CORRIENTES AV. 2038		
CENTRO CULTURAL UNIVERSITARIO DE LA FACULTAD DE PSICOLOGIA UBA	CENTRO CULTURAL	INDEPENDENCIA AV. 3065		
EL TRAILER BAR TEATRO	ESPACIO ESCENICO (TEATRO, MUSICA Y DANZA)	SERRANO 1595		
"INSTITUTO BIBLIOGRAFICO ""ANTONIO ZINNY"""	BIBLIOTECA	TUCUMAN 1958		
"BIBLIOTECA DE MUSICA ARGENTINA ""BLAS PARERA"". SADAIC"	BIBLIOTECA	LAVALLE 1547		
INSTITUTO DE HISTORIA DEL ARTE ARGENTINO Y LATINOAMERICANO FACULTAD DE FILOSOFIA Y LETRAS UBA	ESPACIO DE FORMACION (CARRERAS, SEMINARIOS Y TALLERES)	25 DE MAYO 217		
BIBLIOTECA DE LA UNIVERSIDAD ARGENTINA DE LA EMPRESA	BIBLIOTECA	LIMA 717		
BIBLIOTECA ESTEBAN ECHEVERRIA DE LA LEGISLATURA PORTEÑA	BIBLIOTECA	PERU 160		
ASAMBLEA PERMANENTE POR LOS DERECHOS HUMANOS	ARCHIVO	CALLAO AV. 569		
FUNDACION KONRAD ADENAUER	ESPACIO DE FORMACION (CARRERAS, SEMINARIOS Y TALLERES)	SUIPACHA 1175		
"INSTITUTO DE TEORIA E HISTORIA DEL ARTE ""JULIO E. PAYRO"" - CENTRO DE INVESTIGACION"	ESPACIO DE FORMACION (CARRERAS, SEMINARIOS Y TALLERES)	25 DE MAYO 217		
BIBLIOTECA DEL CONGRESO DE LA NACION	BIBLIOTECA	ALSINA, ADOLFO 1835		
BIBLIOTECA DE LA UNIVERSIDAD ARGENTINA JOHN F. KENNEDY	BIBLIOTECA	RIOBAMBA 157		
INSTITUTO DE LINGUISTICA Y BIBLIOTECA DE LA FACULTAD DE FILOSOFIA Y LETRAS (UBA)	BIBLIOTECA	25 DE MAYO 217		
BIBLIOTECA DEL CENTRO DE ESTUDIOS DE ESTADO Y SOCIEDAD (CEDES)	BIBLIOTECA	SANCHEZ DE BUSTAMANTE 27		
BIBLIOTECA REVERENDO PADRE GUILLERMO FURLONG SJ. UNIVERSIDAD DEL SALVADOR	BIBLIOTECA	PERON, JUAN DOMINGO, TTE. GENERAL 1818		
BIBLIOTECA DE LA ESCUELA NORMAL SUPERIOR NRO 3 BERNARDINO RIVADAVIA	BIBLIOTECA	BOLIVAR 1235		
SERVICIO PAZ Y JUSTICIA - CENTRO DE DOCUMENTACION.	ARCHIVO	PIEDRAS 730		
BIBLIOTECA DE LA FUNDACION PODER CIUDADANO	BIBLIOTECA	PIEDRAS 574		
ARCHIVO NACIONAL DE LA MEMORIA	ARCHIVO	DEL LIBERTADOR AV. 8151		
BIBLIOTECA SAN BENITO ABAD DE LA UNIVERSIDAD CATOLICA ARGENTINA	BIBLIOTECA	MOREAU DE JUSTO, ALICIA AV. 1300		
"BIBLIOTECA ""ENRIQUE PRINS"" DEL INSTITUTO UNIVERSITARIO NACIONAL DEL ARTE"	BIBLIOTECA	ESPAÃ‘A AV. 1701		
BIBLIOTECA LEOPOLDO TETTAMANTI	BIBLIOTECA	ROCA, JULIO A., PRESIDENTE AV. 651		
BIBLIOTECA DE LA COMISION NACIONAL DE COMUNICACIONES	BIBLIOTECA	MEXICO 571		
BIBLIOTECA DEL INSTITUTO NACIONAL DE ESTADISTICA Y CENSOS (INDEC)	BIBLIOTECA	ROCA, JULIO A., PRESIDENTE AV. 609		
CENTRO DE DOCUMENTACION E INVESTIGACION ARQUITECTURA PUBLICA	ARCHIVO	PASEO COLON AV. 171		
BIBLIOTECA DEL CONSEJO NACIONAL DE LA MUJER	BIBLIOTECA	PASEO COLON AV. 275		
BIBLIOTECA DE LA UNIVERSIDAD TECNOLOGICA NACIONAL	BIBLIOTECA	MEDRANO AV. 951		
INSTITUTO UNIVERSITARIO ESCUELA SUPERIOR DE ECONOMIA Y ADMINISTRACION DE EMPRESAS	BIBLIOTECA	URIARTE 2472		
BIBLIOTECA DE LA DIRECCION NACIONAL DE VIALIDAD	BIBLIOTECA	ROCA, JULIO A., PRESIDENTE AV. 734		
UNIVERSIDAD DE FLORES, FACULTAD DE PLANEAMIENTO SOCIOAMBIENTAL Y FACULTAD DE PSICOLOGIA Y CIENCIAS SOCIALES	ESPACIO DE FORMACION (CARRERAS, SEMINARIOS Y TALLERES)	PEDERNERA 275		
UNIVERSIDAD DE LA MARINA MERCANTE, FACULTAD DE JURIDICAS, SOCIALES Y DE LA COMUNICACION.	ESPACIO DE FORMACION (CARRERAS, SEMINARIOS Y TALLERES)	RIVADAVIA AV. 2258		
"INSTITUTO SUPERIOR DE FORMACION ARTISTICA DE ARTES AUDIOVISUALES ""LOLA MORA"""	ESPACIO DE FORMACION (CARRERAS, SEMINARIOS Y TALLERES)	SOLDADO DE LA FRONTERA AV. 5155		
UNIVERSIDAD DE BELGRANO, FACULTAD DE HUMANIDADES Y ARQUITECTURA Y URBANIMO	ESPACIO DE FORMACION (CARRERAS, SEMINARIOS Y TALLERES)	ZABALA 1837		
UNIVERSIDAD DEL MUSEO SOCIAL ARGENTINO, FACULTAD DE CIENCIAS JURIDICAS Y SOCIALES	ESPACIO DE FORMACION (CARRERAS, SEMINARIOS Y TALLERES)	CORRIENTES AV. 1723		
UNIVERSIDAD DEL MUSEO SOCIAL ARGENTINO, FACULTAD DE ARTES	ESPACIO DE FORMACION (CARRERAS, SEMINARIOS Y TALLERES)	SARMIENTO 1565		
INSTITUTO SUPERIOR SANTA ANA	ESPACIO DE FORMACION (CARRERAS, SEMINARIOS Y TALLERES)	DEL LIBERTADOR AV. 6155		
UNIVERSIDAD ABIERTA INTERAMERICANA, FACULTAD DE CIENCIAS DE LA COMUNICACION	ESPACIO DE FORMACION (CARRERAS, SEMINARIOS Y TALLERES)	CHACABUCO 90		
UNIVERSIDAD ARGENTINA JOHN F. KENNEDY, ESCUELA DE DISEÑO GRAFICO	ESPACIO DE FORMACION (CARRERAS, SEMINARIOS Y TALLERES)	MITRE, BARTOLOME 1411		
ESCUELA SUPERIOR DE CREATIVOS PUBLICITARIOS	ESPACIO DE FORMACION (CARRERAS, SEMINARIOS Y TALLERES)	CIUDAD DE LA PAZ 1937		
INSTITUTO GRAFOTECNICO	ESPACIO DE FORMACION (CARRERAS, SEMINARIOS Y TALLERES)	MAIPU 742		
FACULTAD DE ARQUITECTURA, DISEÑO Y URBANISMO	ESPACIO DE FORMACION (CARRERAS, SEMINARIOS Y TALLERES)	GUIRALDES, INT. 2620		
ESCUELA DE MUSICA DE BUENOS AIRES	ESPACIO DE FORMACION (CARRERAS, SEMINARIOS Y TALLERES)	CIUDAD DE LA PAZ 1831		
INSTITUTO CATOLICO DE ESTUDIOS SOCIALES	ESPACIO DE FORMACION (CARRERAS, SEMINARIOS Y TALLERES)	JUNIN 1063		
ESCUELA NACIONAL DE EXPERIMENTACION Y REALIZACION CINEMATOGRAFICA (E.N.E.R.C.)	ESPACIO DE FORMACION (CARRERAS, SEMINARIOS Y TALLERES)	MORENO 1199		
CENTRO DE INVESTIGACION Y EXPERIMENTACION EN VIDEO Y CINE (CIEVYC)	ESPACIO DE FORMACION (CARRERAS, SEMINARIOS Y TALLERES)	COCHABAMBA 868		
CENTRO DE ESTUDIOS BUENOS AIRES	ESPACIO DE FORMACION (CARRERAS, SEMINARIOS Y TALLERES)	BELGRANO AV. 3302		
ESCUELA DE PERIODISMO DEL CIRCULO DE PRENSA	ESPACIO DE FORMACION (CARRERAS, SEMINARIOS Y TALLERES)	PERU 358		
FUNDACION DE ALTOS ESTUDIOS EN CIENCIAS COMERCIALES	ESPACIO DE FORMACION (CARRERAS, SEMINARIOS Y TALLERES)	URUGUAY 57		
INSTITUTO SUPERIOR DE ENSEÑANZA RADIOFONICA (I.S.E.R.)	ESPACIO DE FORMACION (CARRERAS, SEMINARIOS Y TALLERES)	RAMOS MEJIA, JOSE MARIA, DR. AV. 1398		
INSTITUTO TECNOLOGICO DE MUSICA CONTEMPORANEA	ESPACIO DE FORMACION (CARRERAS, SEMINARIOS Y TALLERES)	SAN ISIDRO LABRADOR AV. 4122		
FX PRIMERA ESCUELA ARGENTINA DE EFECTOS ESPECIALES	ESPACIO DE FORMACION (CARRERAS, SEMINARIOS Y TALLERES)	ESTADO DE ISRAEL AV. 4126		
INSTITUTO DE LA ASOCIACION ARGENTINA DE AGENCIAS DE PUBLICIDAD	ESPACIO DE FORMACION (CARRERAS, SEMINARIOS Y TALLERES)	SUIPACHA 1333		
EDITORIAL IMAGINADOR	EDITORIAL	MITRE, BARTOLOME 3749		
EDITORIAL ALFAGUARA	EDITORIAL	ALEM, LEANDRO N. AV. 720		
EDICIONES ABRAN CANCHA	EDITORIAL	GORRITI 3909		
EDICIONES FABRO	EDITORIAL	MONTEVIDEO 641		
EDITORIAL SUDAMERICANA (RANDOM HOUSE MONDADORI)	EDITORIAL	HUMBERTO 1 555		
EDICIONES COLIHUE	EDITORIAL	DIAZ VELEZ AV. 5125		
EDITORIAL TROQUEL	EDITORIAL	OLLEROS AV. 1818		
FONDO DE CULTURA ECONOMICA DE ARGENTINA	EDITORIAL	EL SALVADOR 5665		
EDITORIAL SANTILLANA ARGENTINA	EDITORIAL	ALEM, LEANDRO N. AV. 720		
EDITORIAL ATLANTIDA	EDITORIAL	AZOPARDO 565		
EDITORIAL TINTA FRESCA	EDITORIAL	CORRIENTES AV. 526		
AZ EDITORA	EDITORIAL	MONTENEGRO 1335		
AIQUE GRUPO EDITOR	EDITORIAL	ACUÃ‘A DE FIGUEROA, FRANCISCO 352		
EDICIONES DE LA FLOR	EDITORIAL	GORRITI 3695		
EDITORIAL BIBLOS	EDITORIAL	GIUFFRA, JOSE M.,DR. 324		
LA CRUJIA LIBROS	EDITORIAL	TUCUMAN 1999		
PROMETEO EDITORIAL	EDITORIAL	PRINGLES 519		
EDICIONES CORREGIDOR	EDITORIAL	RODRIGUEZ PE�A 452		
EDICIONES GARNICA	EDITORIAL	LAVALLE 1634		
BENDITAS PRODUCCIONES	SELLO DISCOGRAFICO	BARCO CENTENERA DEL 1203		
BARCA DISCOS - ENTREACTO	SELLO DISCOGRAFICO	MONTE 4929		
ACQUA RECORDS	SELLO DISCOGRAFICO	CORRIENTES AV. 1792		
RGS MUSIC	SELLO DISCOGRAFICO	CORRIENTES AV. 5233		
OPUS 4 PRODUCCIONES	SELLO DISCOGRAFICO	CORDOBA AV. 347		
MUSIPAK	SELLO DISCOGRAFICO	ARENALES 1917		
MDR RECORDS	SELLO DISCOGRAFICO	CALLAO AV. 964		
LEADER MUSIC	SELLO DISCOGRAFICO	SAN JOSE 1277		
EURO RECORDS	SELLO DISCOGRAFICO	LAVALLE 2039		
ETERNAL SUNDAY RECORDS	SELLO DISCOGRAFICO	MIGUELETES 1983		
TROVA INDUSTRIAS MUSICALES	SELLO DISCOGRAFICO	SEGUI, JUAN FRANCISCO 3745		
S-MUSIC	SELLO DISCOGRAFICO	EL SALVADOR 5863		
RP MUSIC (RADOSZYNSKI PRODUCCIONES)	SELLO DISCOGRAFICO	PASTEUR 733		
POLEY RECORDS	SELLO DISCOGRAFICO	OLLEROS 3069		
PLAY PROJECT RECORDS	SELLO DISCOGRAFICO	PERON, JUAN DOMINGO, TTE. GENERAL 2049		
MAGENTA DISCOS	SELLO DISCOGRAFICO	COLOMBRES 107		
POP ART MUSIC	SELLO DISCOGRAFICO	ARENAL, CONCEPCION 2978		
PELO MUSIC	SELLO DISCOGRAFICO	ORTIZ DE OCAMPO AV. 3050		
RANDOM RECORDS	SELLO DISCOGRAFICO	SANTA FE AV. 4870		
PINHEAD RECORDS	SELLO DISCOGRAFICO	CABRERA, JOSE A. 5674		
LIBRERIA YENNY. SUCURSAL ABASTO.	LIBRERIA	CORRIENTES AV. 3247		
PROMETEO LIBROS. SUCURSAL HONDURAS.	LIBRERIA	HONDURAS 4912		
ZIVALS	LIBRERIA	CALLAO AV. 395		
JOYCE, PROUST & CO. LENGUAS Y LITERATURAS EXTRANJERAS	LIBRERIA	TUCUMAN 1545		
LIBRERIA LIBERTADOR	LIBRERIA	CORRIENTES AV. 1318		
RIGOLETTO CURIOSO	LIBRERIA	CORRIENTES AV. 1660		
EL LIBRO DE ARENA. SUCURSAL ARAOZ.	LIBRERIA	ARAOZ 594		
ANTICUARIO LORD BYRON	LIBRERIA	LIBERTAD 948		
MACONDO LIBROS. SUCURSAL SALGUERO.	LIBRERIA	SALGUERO, JERONIMO 1833		
LAS MIL Y UNA HOJAS. SUCURSAL L. M. CAMPOS.	LIBRERIA	CAMPOS, LUIS M. AV. 1384		
LIBRERIA NADIR. SUCURSAL ALBERDI.	LIBRERIA	ALBERDI, JUAN BAUTISTA AV. 5853		
NUEVA LIBRERIA	LIBRERIA	ESTADOS UNIDOS 301		
LA OFERTA. SUCURSAL CORRIENTES.	LIBRERIA	CORRIENTES AV. 1906		
CINCENTRO PRODUCCIONES	PRODUCTORA AUDIOVISUAL	URIBURU JOSE E., PRES. 277		
ANIMA FILMS	PRODUCTORA AUDIOVISUAL	LAVALLEJA 1274		
LIBRERIA OTRO MUNDO	LIBRERIA	ARMENIA 2432		
AJI FILMS	PRODUCTORA AUDIOVISUAL	COMBATIENTES DE MALVINAS AV. 3852		
PROMETEO LIBROS. SUCURSAL CORRIENTES (CASA CENTRAL).	LIBRERIA	CORRIENTES AV. 1916		
SAN BERNARDO PRODUCCIONES	PRODUCTORA AUDIOVISUAL	PERON, JUAN DOMINGO, TTE. GENERAL 1578		
SUBTERRANEA FILMS	PRODUCTORA AUDIOVISUAL	PERU 675		
LIBRERIA SANTA FE. SUCURSAL SANTA FE I.	LIBRERIA	SANTA FE AV. 2376		
16.9 PRODUCCIONES	PRODUCTORA AUDIOVISUAL	INCLAN 2541		
SBS LIBRERIA INTERNACIONAL. SUCURSAL PARQUE CHACABUCO.	LIBRERIA	DIAZ, AVELINO 533		
25P FILMS	PRODUCTORA AUDIOVISUAL	ARENAL, CONCEPCION 3425		
WALRUS BOOKS	LIBRERIA	ESTADOS UNIDOS 617		
AUDIOVISUALES DEL SUR	PRODUCTORA AUDIOVISUAL	AZURDUY JUANA 1553		
GRUPO DE BOEDO FILMS	PRODUCTORA AUDIOVISUAL	QUINQUELA MARTIN, BENITO 1774		
BRANCALEONE PRODUCTORA	PRODUCTORA AUDIOVISUAL	VERA 553		
JUAN JOSE ARA, LIBROS DE MEDICINA	LIBRERIA	BACACAY 2547		
BS. AS. PRODUCCIONES	PRODUCTORA AUDIOVISUAL	CABELLO 3791		
BUFFALO FILMS	PRODUCTORA AUDIOVISUAL	SCALABRINI ORTIZ, RAUL AV. 140		
KEL EDICIONES. SUCURSAL AV. LA PLATA.	LIBRERIA	LA PLATA AV. 63		
CALMA CINE	PRODUCTORA AUDIOVISUAL	NAON, ROMULO 4185		
CM PRODUCCIONES	PRODUCTORA AUDIOVISUAL	TALCAHUANO 374		
AQUA FILMS	PRODUCTORA AUDIOVISUAL	CABELLO 3644		
THOR RECORDS	DISQUERIA	SANTA FE AV. 1670		
DISCOVER	DISQUERIA	FLORIDA 537		
DISCOS OPUS	DISQUERIA	BOLIVIA 47		
AL FIN DEL MUNDO	PRODUCTORA AUDIOVISUAL	GIRIBONE 629		
100 BARES	PRODUCTORA AUDIOVISUAL	LEMOS, JUAN GREGORIO, GRAL. 160		
EL ZOCALO	PRODUCTORA AUDIOVISUAL	CHARLONE 64		
ARTEAR	PRODUCTORA AUDIOVISUAL	LIMA 1261		
CLUB DEL DISCO	DISQUERIA	LAVALLE 3685		
BD CINE	PRODUCTORA AUDIOVISUAL	ALVAREZ THOMAS AV. 198		
CASA PISCITELLI	DISQUERIA	SAN MARTIN 450		
SEGUI VINIENDO DISCOS	DISQUERIA	BALCARCE 260		
LS 86 - TV CANAL 2	TELEVISION LOCAL	FITZ ROY 1650		
TEMPO DISQUERIA	DISQUERIA	BORGES, JORGE LUIS 1666		
LS 82 - TV CANAL 7	TELEVISION LOCAL	FIGUEROA ALCORTA, PRES. AV. 2977		
ICONOS	DISQUERIA	GUALEGUAYCHU 3824		
LS 83 - TV CANAL 9	TELEVISION LOCAL	CONDE 50		
ETILUX SRL	DISQUERIA	LA PAMPA 4411		
LS 84 - TV CANAL 11	TELEVISION LOCAL	PAVON 2444		
DOS MUSIC SHOP	DISQUERIA	RIVADAVIA AV. 2517		
LS 85 - TV CANAL 13	TELEVISION LOCAL	LIMA 1261		
JAZZ DISQUERIA	DISQUERIA	LAVALLE 809		
DISQUERIA KILI	DISQUERIA	BRASIL 1225		
DISQUERIA BRUNELLI	DISQUERIA	DEAN FUNES 2193		
DAVID GIL	DISQUERIA	LOPE DE VEGA AV. 3309		
DANIEL E. CASARIEGO	DISQUERIA	RIVADAVIA AV. 11440		
CASA ROBIMAR	DISQUERIA	SAENZ AV. 1161		
AXEL DISCOS	DISQUERIA	RIVADAVIA AV. 11450		
DISQUERIA PETRACCA	DISQUERIA	ALBERDI, JUAN BAUTISTA AV. 5793		
CASA DE GALICIA (CLUB ESPAÑOL)	MILONGA Y/O TANGUERIA	SAN JOSE 224		
EL COLECCIONISTA, TIENDA DE MUSICA	DISQUERIA	ESMERALDA 562		
LA 100 FM 99.9	RADIO LOCAL (AM Y FM)	MANSILLA, LUCIO NORBERTO, GENERAL 2668		
ESPACIO GIESSO	GALERIA DE ARTE	COCHABAMBA 370		
ROCK AND POP FM 95.9	RADIO LOCAL (AM Y FM)	FREIRE, RAMON, CAP. GRAL. 932		
VYP GALERIAS	GALERIA DE ARTE	ARROYO 959		
METRO FM 95.1	RADIO LOCAL (AM Y FM)	FREIRE, RAMON, CAP. GRAL. 932		
GALERIA DE ARTE SYLVIA VESCO	GALERIA DE ARTE	CHACABUCO 866		
LA 2X4 FM 92.7	RADIO LOCAL (AM Y FM)	SARMIENTO 1551		
GRUPO SUAR S.R.L.	PRODUCTORA AUDIOVISUAL	LAVALLEJA 1021		
BDF BUEN DIA FILMS	PRODUCTORA AUDIOVISUAL	GUEVARA 1282		
RADIO DEL PLATA AM 1030	RADIO LOCAL (AM Y FM)	GORRITI 5963		
LUNATICA FILMS ARGENTINA	PRODUCTORA AUDIOVISUAL	MENDEZ, NICANOR 2540		
14 AL CENTRO	PRODUCTORA AUDIOVISUAL	DEHEZA 2230		
RADIO AMERICA AM 1190	RADIO LOCAL (AM Y FM)	AMENABAR 23		
BIG BUDDHA	PRODUCTORA AUDIOVISUAL	CABRERA, JOSE A. 5671		
RADIO RIVADAVIA AM 630	RADIO LOCAL (AM Y FM)	ARENALES 2467		
RADIO CONTINENTAL AM 590	RADIO LOCAL (AM Y FM)	RIVADAVIA AV. 835		
RADIO 10 AM 710	RADIO LOCAL (AM Y FM)	URIARTE 1899		
RADIO MITRE AM 790	RADIO LOCAL (AM Y FM)	MANSILLA, LUCIO NORBERTO, GENERAL 2668		
RADIO NACIONAL AM 870	RADIO LOCAL (AM Y FM)	MAIPU 555		
LA RED AM 910	RADIO LOCAL (AM Y FM)	PASEO COLON AV. 505		
RADIO DE LA CIUDAD AM 1110	RADIO LOCAL (AM Y FM)	SARMIENTO 1551		
BLUE FM 100.7	RADIO LOCAL (AM Y FM)	HONDURAS 5691		
X4 FM 104.3	RADIO LOCAL (AM Y FM)	VEGA, NICETO, CNEL. AV. 5635		
FM PATRICIOS FM 95.5	RADIO LOCAL (AM Y FM)	24 DE NOVIEMBRE 2273		
RADIO PALERMO FM 94.7	RADIO LOCAL (AM Y FM)	RAVIGNANI, EMILIO, DR. 1732		
FM LA TRIBU FM 88.7	RADIO LOCAL (AM Y FM)	LAMBARE 873		
RADIO UBA FM 87.9	RADIO LOCAL (AM Y FM)	ARENALES 1371		
LA RADIO DE LAS MADRES AM 530	RADIO LOCAL (AM Y FM)	SAENZ PE�A, LUIS, PRES. 210		
ASPEN CLASSIC FM 102.3	RADIO LOCAL (AM Y FM)	HONDURAS 5663		
RADIO GENERAL BELGRANO AM 840	RADIO LOCAL (AM Y FM)	TRAFUL 3834		
BAZAR TV NEWS	PRODUCTORA AUDIOVISUAL	MONTEVIDEO 1780		
RADIO EL MUNDO AM 1070	RADIO LOCAL (AM Y FM)	RIVADAVIA AV. 825		
FM IDENTIDAD FM 92.1	RADIO LOCAL (AM Y FM)	FLORIDA 935		
BASTIANA FILMS	PRODUCTORA AUDIOVISUAL	DIAZ, CNEL. AV. 2277		
RADIO JAI FM 96.3	RADIO LOCAL (AM Y FM)	GOMEZ, VALENTIN 2950		
BANDA APARTE	PRODUCTORA AUDIOVISUAL	THAMES 2005		
AZTECA FILMS	PRODUCTORA AUDIOVISUAL	LACROZE, FEDERICO AV. 2886		
CLASICA NACIONAL FM 96.7	RADIO LOCAL (AM Y FM)	MAIPU 555		
AZPEITIA CINE	PRODUCTORA AUDIOVISUAL	BILLINGHURST 1087		
NACIONAL FOLKLORICA FM 98.7	RADIO LOCAL (AM Y FM)	MAIPU 555		
LETRA IMPRESA GRUPO EDITOR	EDITORIAL	PALPA 3672		
ASST	PRODUCTORA AUDIOVISUAL	CASTEX 3217		
ONDA LATINA AM 1010	RADIO LOCAL (AM Y FM)	SARMIENTO 1586		
ARMADO FILMS	PRODUCTORA AUDIOVISUAL	BULNES 1047		
EDITORIAL DISTAL	EDITORIAL	PASEO COLON AV. 1350		
EDITORIAL ALBATROS	EDITORIAL	SALGUERO, JERONIMO 2745		
ARGENTINA CINE	PRODUCTORA AUDIOVISUAL	DARWIN 1154		
EDICIONES DEL ARROYO	EDITORIAL	TUCUMAN 1427		
ENCUADRE S.A.	PRODUCTORA AUDIOVISUAL	3 DE FEBRERO 2841		
VORTERIX FM 103.1	RADIO LOCAL (AM Y FM)	LACROZE, FEDERICO AV. 3455		
EDITORIAL LEVIATAN	EDITORIAL	ALSINA, ADOLFO 1170		
AIKE SUR	PRODUCTORA AUDIOVISUAL	CARRANZA, ANGEL JUSTINIANO 2038		
RADIO SPLENDID AM 990	RADIO LOCAL (AM Y FM)	SAN MARTIN 569		
AD-ONE	PRODUCTORA AUDIOVISUAL	UGARTE, MANUEL 2783		
PARADISO EDICIONES	EDITORIAL	ACUÃ‘A DE FIGUEROA, FRANCISCO 786		
RADIO 9 LA DEPORTIVA AM 950	RADIO LOCAL (AM Y FM)	CONDE 935		
ARMONIZATE MEDIA	PRODUCTORA AUDIOVISUAL	AGUILAR 2612		
EDITORIAL MODALITE	EDITORIAL	PRINGLES 1321		
DONN S.A.	EDITORIAL	CORTEJARENA, JOSE A. 1862		
NUTS STUDIO S.A.	PRODUCTORA AUDIOVISUAL	SCALABRINI ORTIZ, RAUL AV. 764		
EDITORIAL ESTELLA - EDUCAR PARA LA LIBERTAD	EDITORIAL	VIAMONTE 1984		
HYPNOSIS FILMS	PRODUCTORA AUDIOVISUAL	CONESA 3053		
RADIO DEL PUEBLO AM 830	RADIO LOCAL (AM Y FM)	MONTEVIDEO 497		
DOS EDITORES/DOS TINTAS S.A.	EDITORIAL	BALCARCE 711		
EDITORIAL ERA NACIENTE	EDITORIAL	SAN JUAN AV. 777		
ESPACIO EDITORIAL	EDITORIAL	BOLIVAR 547		
CONSEJO PROFESIONAL DE CIENCIAS ECONOMICAS DE LA CAPITAL FEDERAL	EDITORIAL	VIAMONTE 1549		
EDICIONES MANANTIAL	EDITORIAL	DE MAYO AV. 1365		
RADIO COOPERATIVA AM 770	RADIO LOCAL (AM Y FM)	CERRITO 242		
FERNANDO MARIN PRODUCCIONES	PRODUCTORA AUDIOVISUAL	MADERO, EDUARDO AV. 942		
ALFAGRAMA EDICIONES	EDITORIAL	ZAPATA 160		
ALPHA CHANNEL	PRODUCTORA AUDIOVISUAL	FRIAS, EUSTAQUIO, TTE. GENERAL 263		
AMADEO DIGITAL	PRODUCTORA AUDIOVISUAL	3 DE FEBRERO 4856		
AMORRORTU EDITORES	EDITORIAL	PARAGUAY 1225		
ARCA DIFUSION	PRODUCTORA AUDIOVISUAL	MAIPU 916		
COSMOPOLITA	EDITORIAL	PIEDRAS 744		
AREA 54 FILMS	PRODUCTORA AUDIOVISUAL	VEGA, NICETO, CNEL. 4932		
AREA DIGITAL	PRODUCTORA AUDIOVISUAL	AREVALO 1977		
EDITORIAL ISRAELITA BNEI SHOLEM	EDITORIAL	ANCHORENA, TOMAS MANUEL DE, DR. 762		
AM 750	RADIO LOCAL (AM Y FM)	VENEZUELA 370		
CRECER CREANDO	EDITORIAL	VIAMONTE 2052		
CLACK STUDIO	PRODUCTORA AUDIOVISUAL	LACROZE, FEDERICO AV. 3106		
RADIO ARGENTINA AM 570	RADIO LOCAL (AM Y FM)	SAN MARTIN 569		
CLYNA S.A.	EDITORIAL	CERRITO 1136		
EDITORIAL PERSPECTIVAS BET MIDRASH	EDITORIAL	TUCUMAN 2757		
RADIO BUENOS AIRES AM 1350	RADIO LOCAL (AM Y FM)	ENTRE RIOS AV. 1931		
SOCIEDAD BIBLICA ARGENTINA	EDITORIAL	TUCUMAN 352		
RADIO CONCEPTO AM 730	RADIO LOCAL (AM Y FM)	MAIPU 267		
CLACSO - AREA DE PRODUCCION EDITORIAL	EDITORIAL	CALLAO AV. 875		
ASTREA EDITORIAL	EDITORIAL	LAVALLE 1208		
CONTINENTE EDICIONES	EDITORIAL	PAVON 2229		
CINE TAURO	PRODUCTORA AUDIOVISUAL	TRONADOR 671		
CIRCULO LATINO AUSTRAL	EDITORIAL	CASEROS AV. 1573		
CINE OJO	PRODUCTORA AUDIOVISUAL	LAVALLE 3		
BALLETIN DANCE	EDITORIAL	ALSINA, ADOLFO 943		
GRUPO EDITORIAL CIUDAD NUEVA	EDITORIAL	LEZICA 4358		
CINEMA GROUP S.R.L.	PRODUCTORA AUDIOVISUAL	SCALABRINI ORTIZ, RAUL AV. 140		
CLARETIANA EDITORIAL. SUCURSAL LIMA.	EDITORIAL	LIMA 1360		
CICLO UNO PRODUCTORA	PRODUCTORA AUDIOVISUAL	CASTILLO 1366		
CLEO ART CLUB	EDITORIAL	ARENALES 2532		
EDITORIAL ABELEDO PERROT	EDITORIAL	LAVALLE 1280		
EDITORIAL BAHA'' INDOLATINOAMERICANA	EDITORIAL	OTAMENDI 217		
COMPANIA CINEMATOGRAFICA	PRODUCTORA AUDIOVISUAL	GUATEMALA 5188		
EDICIONES ANDROMEDA	EDITORIAL	LA PLATA AV. 1268		
SALADO MEDIA	PRODUCTORA AUDIOVISUAL	CARRANZA, ANGEL JUSTINIANO 1970		
PROYECTO BASE	EDITORIAL	SANTA FE AV. 1460		
16M EL ANGEL FILMS	PRODUCTORA AUDIOVISUAL	SERRANO 820		
CATAPULTA EDITORES/CATAPULTA JUNIOR	EDITORIAL	DONADO 4694		
ATVEL EDITORIAL	EDITORIAL	PICHINCHA 1091		
ARTNOVELA EDICIONES	EDITORIAL	MOREAU DE JUSTO, ALICIA AV. 1120		
GRUPO EDIBA	EDITORIAL	FOREST AV. 579		
PEARSON EDUCACION	EDITORIAL	BELGRANO AV. 615		
TUSQUETS EDITORES S.A.	EDITORIAL	VENEZUELA 1664		
PICHUCO RECORDS	SELLO DISCOGRAFICO	PARANA 641		
V & R EDITORAS S.A.	EDITORIAL	DEMARIA 4412		
ATLANTE ARGENTINA EDITORIAL	EDITORIAL	JUNIN 827		
EDITORIAL SIGMAR	EDITORIAL	BELGRANO AV. 1580		
EDIAR	EDITORIAL	TUCUMAN 927		
KAPELUSZ EDICIONES	EDITORIAL	SAN JOSE 831		
PROCOM DISCOS	SELLO DISCOGRAFICO	RIVERA, PEDRO I., DR. 5738		
KATZ EDITORES	EDITORIAL	MATIENZO, BENJAMIN, TENIENTE 1831		
RIGOR RECORDS	SELLO DISCOGRAFICO	MENDEZ DE ANDES 2355		
GRUPO VISOR	EDITORIAL	ARBELETCHE, ANIBAL P. 1580		
YORK AGENCY	EDITORIAL	ALSINA, ADOLFO 739		
ALFAOMEGA GRUPO EDITOR	EDITORIAL	PARAGUAY 1307		
SURAMUSIC	SELLO DISCOGRAFICO	ALVAREZ THOMAS AV. 637		
EDICIONES B / GRUPO Z	EDITORIAL	PASEO COLON AV. 221		
VACA RECORDS	SELLO DISCOGRAFICO	BESARES 1931		
EDICIONES LEA	EDITORIAL	DORREGO AV. 330		
EDICIONES SM	EDITORIAL	BELGRANO AV. 552		
ESTAMOS FELICES	SELLO DISCOGRAFICO	LOPEZ, VICENTE 2305		
EDICIONES MADRES DE PLAZA DE MAYO	EDITORIAL	YRIGOYEN, HIPOLITO 1432		
EDITORIAL ANDRES BELLO ARGENTINA	EDITORIAL	RIO CUARTO 2765		
EDITORIAL ABACO	EDITORIAL	VIAMONTE 1336		
GLD (GRUPO LASER DISC)	SELLO DISCOGRAFICO	11 DE SEPTIEMBRE DE 1888 3585		
EDITORIAL HEMISFERIO SUR	EDITORIAL	PASTEUR 743		
EDITORIAL CROQUIS	EDITORIAL	VIAMONTE 947		
MARKA	SELLO DISCOGRAFICO	PERON, JUAN DOMINGO, TTE. GENERAL 1593		
EDITORIAL LOS ANDES	EDITORIAL	GALICIA 414		
EDITORIAL MEDICA PANAMERICANA	EDITORIAL	ALVEAR, MARCELO T. DE 2145		
MELOPEA DISCOS	SELLO DISCOGRAFICO	ACHA, MARIANO, GRAL. 3037		
MUSIC BROKERS ARGENTINA	SELLO DISCOGRAFICO	VUELTA DE OBLIGADO 1947		
NEMS ENTERPRISES	SELLO DISCOGRAFICO	RIO DE JANEIRO 9		
PAI PRODUCCIONES ARGENTINAS E INTERNACIONALES	SELLO DISCOGRAFICO	GALICIA 1290		
ASTERISCO	SELLO DISCOGRAFICO	TUCUMAN 731		
AVA RECORDS	SELLO DISCOGRAFICO	PELLEGRINI, CARLOS 155		
AZIONE ARTIGINIALE	SELLO DISCOGRAFICO	VARELA 236		
BESOTICO RECORDS	SELLO DISCOGRAFICO	MORENO 1876		
BLACKSIDE INC.	SELLO DISCOGRAFICO	LOZANO, PEDRO 3792		
CICLO 3	SELLO DISCOGRAFICO	ESTADOS UNIDOS 629		
DISCOS REDONDEL	SELLO DISCOGRAFICO	BUCARELLI 2626		
MUSEO NOTARIAL ARGENTINO	MUSEO	CALLAO AV. 1542		
MUSEO DE LA EMIGRACION GALLEGA EN LA ARGENTINA M.E.G.A.	MUSEO	CHACABUCO 955		
PAIDOS GRUPO PLANETA	EDITORIAL	INDEPENDENCIA AV. 1682		
EDICIONES EL ANDARIEGO	EDITORIAL	ARAOZ 577		
VAZQUEZ MAZZINI EDITORES	EDITORIAL	TINOGASTA 3171		
EDEBE	EDITORIAL	DON BOSCO 4069		
ESTACION MANDIOCA DE EDICIONES	EDITORIAL	BONIFACIO, JOSE 2524		
EDELVIVES ARGENTINA	EDITORIAL	CALLAO AV. 224		
UGERMAN EDITOR	EDITORIAL	ITUZAINGO 1151		
EDITORIAL UNIVERSIDAD	EDITORIAL	RIVADAVIA AV. 1225		
XYZ EDITORA S.A.	EDITORIAL	HUERGO, ING. AV. 1181		
ANTIDOTO EDITORIAL	EDITORIAL	CHILE 1302		
PEQUEÑO EDITOR	EDITORIAL	CHARLONE 978		
PLAQUETODO	EDITORIAL	INCLAN 3955		
EDITORIAL POLEMOS	EDITORIAL	MORENO 1785		
PRODUCCIONES MAWIS	EDITORIAL	LAMARCA, EMILIO 1917		
EDITORIAL REMOLINO	EDITORIAL	AZCUENAGA 24		
EDITORIAL RUY DIAZ	EDITORIAL	GONZALEZ, ELPIDIO 5562		
EDITORIAL SAN PABLO	EDITORIAL	RIOBAMBA 230		
EDITORIAL SERENDIPIDAD	EDITORIAL	HUERGO, ING. AV. 1485		
SESSA EDITORES	EDITORIAL	BOLLINI 2234		
SIGLO VEINTIUNO EDITORES	EDITORIAL	GUATEMALA 4824		
SOUTH END PUBLISHING	EDITORIAL	ARAOZ 558		
LUGAR EDITORIAL S.A.	EDITORIAL	CASTRO BARROS 1754		
CINES PLAZA LINIERS SHOPPING CENTER	CINE	FALCON, RAMON L.,CNEL. 7145		
CINEMARK CABALLITO	CINE	LA PLATA AV. 96		
CINEMARK PALERMO	CINE	BERUTI 3399		
CINEMARK PUERTO MADERO	CINE	MOREAU DE JUSTO, ALICIA AV. 1960		
PIAZZOLLA TANGO	MILONGA Y/O TANGUERIA	FLORIDA 165		
TEATRO LA GALERA	ESPACIO ESCENICO (TEATRO, MUSICA Y DANZA)	HUMBOLDT 1591		
STADIUM EDITORIAL	EDITORIAL	INDEPENDENCIA AV. 3124		
EDICIONES LUMIERE	EDITORIAL	AZARA 65		
MAGISTERIO DEL RIO DE LA PLATA	EDITORIAL	VIAMONTE 1674		
MALAS PALABRAS BUKS	EDITORIAL	PARAGUAY 749		
MASCARDI & NASH	EDITORIAL	PARANA 1097		
MC GRAW-HILL INTERAMERICANA EDITORES	EDITORIAL	ARENAL, CONCEPCION 3425		
MIÑO Y DAVILA EDITORES	EDITORIAL	RIVADAVIA AV. 1977		
NISEOS EDITORIAL DE HISTORIA MILITAR	EDITORIAL	DE MAYO AV. 1370		
EDICIONES NISNO	EDITORIAL	ROSETI 181		
NOBUKO	EDITORIAL	FLORIDA 683		
OLMO EDICIONES	EDITORIAL	ALVEAR, MARCELO T. DE 2261		
EDITORIAL OMEBA	EDITORIAL	MORENO 2554		
OSMAR BUYATTI LIBRERIA EDITORIAL	EDITORIAL	VIAMONTE 1509		
PATRIA GRANDE EDITORA	EDITORIAL	RIVADAVIA AV. 6369		
LA AZOTEA EDITORIAL FOTOGRAFICA DE AMERICA LATINA	EDITORIAL	PARAGUAY 1480		
EDITORIAL LA BOHEMIA	EDITORIAL	PATRICIAS ARGENTINAS AV. 111		
EDICIONES LA ROCCA	EDITORIAL	TALCAHUANO 458		
LAFFONT	EDITORIAL	REGIMIENTO DE PATRICIOS AV. 929		
ED LAZARA GUIA DEL ESTUDIANTE	EDITORIAL	PRINGLES 160		
LETEMENDIA CASA EDITORA	EDITORIAL	FLORIDA 336		
EDICIONES QUIPU	EDITORIAL	BONIFACIO, JOSE 2434		
LIBROS DEL ZORZAL	EDITORIAL	TUCUMAN 3350		
EDITORIAL LOSADA	EDITORIAL	MORENO 3362		
EDITORIAL GALERNA	EDITORIAL	LAMBARE 893		
HAMMURABI EDITORIAL S.R.L.	EDITORIAL	TALCAHUANO 481		
HELIASTA EDITORIAL	EDITORIAL	JUNCAL 3451		
EDITORIAL HOLA CHICOS	EDITORIAL	CALLAO AV. 1121		
GRUPO EDITOR VESTALES	EDITORIAL	CANTILO, JOSE LUIS 4200		
NEW GATE TRAVEL MEDIA	EDITORIAL	VIAMONTE 723		
JORGE BAUDINO EDICIONES	EDITORIAL	FRAY CAYETANO RODRIGUEZ 885		
EDICIONES EN DANZA	EDITORIAL	JOVELLANOS, GASPAR M. DE 1068		
KIER	EDITORIAL	SANTA FE AV. 1260		
LIBRERIA ETERNA CADENCIA	LIBRERIA	HONDURAS 5574		
GRUPO EDITORIAL TEMAS	EDITORIAL	CERRITO 136		
EUDEBA	EDITORIAL	RIVADAVIA AV. 1571		
EUROS EDITORES	EDITORIAL	CONGRESO AV. 4744		
INSTITUTO DE PUBLICACIONES NAVALES	EDITORIAL	FLORIDA 971		
LIBRERIA-EDITORIAL CRISTIANA. FUNDACION CRISTIANA DE EVANGELIZACION.	EDITORIAL	MAIPU 466		
NUEVA SOCIEDAD - DEMOCRACIA Y POLITICA EN AMERICA LATINA	EDITORIAL	DEFENSA 1111		
EDITORIAL ERREPAR	EDITORIAL	PARANA 725		
FUNDACION MUNDO NUEVO	EDITORIAL	CALLAO AV. 1870		
EDITORIAL OCEANO ARGENTINA	EDITORIAL	PELLEGRINI, CARLOS 855		
GRAFICA SUR EDITORA SRL	EDITORIAL	MEXICO 1448		
ADRIANA HIDALGO EDITORIAL	EDITORIAL	VITTORIA FRANCISCO DE 2324		
ANSWER JUST TIME S.R.L.	EDITORIAL	SUIPACHA 987		
GRAM EDITORA	EDITORIAL	COCHABAMBA 1652		
GRAN ALDEA EDITORES	EDITORIAL	CAMARONES 1762		
UTILISIMA SATELITAL	PRODUCTORA AUDIOVISUAL	PIEDRAS 1080		
GRUPO CLASA - CULTURAL LIBRERA AMERICANA S.A.	EDITORIAL	BELGRANO AV. 1494		
EDITORIAL GUADAL - EL GATO DE HOJALATA	EDITORIAL	DE MAYO AV. 1209		
EDITORIAL GUADALUPE	EDITORIAL	MANSILLA, LUCIO NORBERTO, GENERAL 3865		
HASA EDITORIAL HISPANOAMERICANA	EDITORIAL	SAN JUAN AV. 1338		
EDITORIAL Y REVISTA TOPIA	EDITORIAL	GUTIERREZ, JUAN MARIA 3809		
AKADIA LIBRERIA Y EDITORIAL	LIBRERIA	PARAGUAY 2078		
EDITORIAL ARGENTA	EDITORIAL	CORRIENTES AV. 1250		
ASUNTO IMPRESO EDICIONES	EDITORIAL	RIVAROLA, RODOLFO, DR. 115		
EDICIONES DEL SIGNO	EDITORIAL	ALVAREZ, JULIAN 2844		
MUSEO DE ARTE LATINOAMERICANO DE BUENOS AIRES (MALBA)	MUSEO	FIGUEROA ALCORTA, PRES. AV. 3415		
1960 TIERRA ADENTRO	LIBRERIA	RUSSEL 5017		
MUNDO HISPANO	LIBRERIA	RIVADAVIA AV. 3474		
ABC LIBRERIAS	LIBRERIA	LOPE DE VEGA AV. 3128		
ABRAXAS	LIBRERIA	PARAGUAY 3964		
ACCION	LIBRERIA	MORENO 457		
ACME AGENCY. CASA CENTRAL.	LIBRERIA	SUIPACHA 245		
AD-HOC VILLELA EDITOR	LIBRERIA	VIAMONTE 1450		
AGAPE LIBROS	LIBRERIA	ESMERALDA 755		
AGAPE LIBROS. SUCURSAL VILLA DEVOTO.	LIBRERIA	CUBAS, JOSE 3469		
AGROPECUARIA	LIBRERIA	PASTEUR 743		
AGUILAR LIBRERIA	LIBRERIA	BLANCO ENCALADA 2376		
ALBERTO CASARES	LIBRERIA	SUIPACHA 521		
EL ALEPH	LIBRERIA	CORRIENTES AV. 4790		
ALETHEIA	LIBRERIA	FLORIDA 835		
LIBRERIA Y EDITORIAL ALSINA	LIBRERIA	PARANA 137		
LIBRERIA DEL ALUMNO	LIBRERIA	MITRE, BARTOLOME 2101		
ANDORRA	LIBRERIA	MITRE, BARTOLOME 2109		
ANTAMI LIBROS	LIBRERIA	PICHINCHA 45		
LIBRERIA DE ANTAÑO	LIBRERIA	LIBERTAD 1236		
LIBRERIA ANTICUARIA EDGARDO HENSCHEL	LIBRERIA	RECONQUISTA 533		
LIBRERIA ANTIGONA. SUCURSAL CENTRO CULTURAL DE LA COOPERACION.	LIBRERIA	CORRIENTES AV. 1543		
LIBERARTE BODEGA CULTURAL	ESPACIO ESCENICO (TEATRO, MUSICA Y DANZA)	CORRIENTES AV. 1555		
LIBRERIA ANTIGONA. SUCURSAL CALLAO.	LIBRERIA	CALLAO AV. 737		
ANTIGUA	LIBRERIA	RIVADAVIA AV. 1175		
APLICACION TRIBUTARIA S.A.	LIBRERIA	VIAMONTE 1550		
"LIBRERIA CORDOBA - ""APUNTES"" LIBROS"	LIBRERIA	PARANA 1013		
AQUILEA	LIBRERIA	CORRIENTES AV. 2008		
ARCADIA LIBROS	LIBRERIA	ALVEAR, MARCELO T. DE 1548		
ASUNTO IMPRESO	LIBRERIA	RIVAROLA, RODOLFO, DR. 153		
ASUNTO IMPRESO. SUCURSAL PERU.	LIBRERIA	PERU 1064		
EL ATENEO. SUCURSAL SANTA FE.	LIBRERIA	SANTA FE AV. 1860		
EL ATENEO. SUCURSAL CABILDO.	LIBRERIA	CABILDO AV. 2093		
EL ATENEO. SUCURSAL FLORIDA.	LIBRERIA	FLORIDA 340		
EL ATENEO. SUCURSAL FLORIDA II.	LIBRERIA	FLORIDA 629		
EL AVE FENIX	LIBRERIA	PUEYRREDON AV. 1753		
LA LIBRERIA DE AVILA	LIBRERIA	ALSINA, ADOLFO 500		
EL BANQUETE. SUCURSAL CABILDO.	LIBRERIA	CABILDO AV. 1107		
LA BARCA LIBROS	LIBRERIA	SCALABRINI ORTIZ, RAUL 3048		
BECA	LIBRERIA	LEBENSOHN, MOISES 914		
BEKER LIBROS	LIBRERIA	LAVALLE 2040		
BIBLIOTERAPIA	LIBRERIA	SAN MARTIN AV. 2392		
LIBRERIA BIBLOS	LIBRERIA	PUAN 378		
BOLSA DEL LIBRO CUARTO INTERMEDIO	LIBRERIA	TUCUMAN 1438		
BOOK CENTER	LIBRERIA	JUNIN 84		
LIBROS DEL PASAJE	LIBRERIA	THAMES 1762		
BRUJAS	LIBRERIA	RODRIGUEZ PE�A 429		
BUENOS AIRES BOOKS	LIBRERIA	SALTA 742		
BUENOS AIRES BOOKS. SUCURSAL URIBURU.	LIBRERIA	URIBURU JOSE E., PRES. 637		
LOS CACHORROS	LIBRERIA	DIAZ VELEZ AV. 5011		
CADAQUES	LIBRERIA	SCALABRINI ORTIZ, RAUL AV. 181		
CALEIDOSCOPIO	LIBRERIA	ECHEVERRIA 3268		
CAPITULO DOS	LIBRERIA	CABELLO 3615		
CASA MARIO	LIBRERIA	ALBERDI, JUAN BAUTISTA AV. 6694		
CASASSA Y LORENZO LIBREROS. CASA CENTRAL.	LIBRERIA	ALVAREZ JONTE AV. 4461		
CASASSA Y LORENZO LIBREROS. SUCURSAL CUENCA.	LIBRERIA	CUENCA 3285		
CLUB PREMIER	ESPACIO ESCENICO (TEATRO, MUSICA Y DANZA)	CAMPICHUELO 472		
TANGO PORTEÑO	MILONGA Y/O TANGUERIA	CERRITO 570		
"BIBLIOTECA ""DR. VICTOR RAUL MAITELLO"" DE LA ASOCIACION NEFROLOGICA DE BUENOS AIRES"	BIBLIOTECA	GASCON 88		
ESPACIO ARTISTICO COLETTE	ESPACIO ESCENICO (TEATRO, MUSICA Y DANZA)	CORRIENTES AV. 1660		
CINE ARTEPLEX DEL PARQUE	CINE	CUENCA 3035		
CINE ARTEPLEX CENTRO	CINE	SAENZ PE�A, ROQUE, PRES. AV. 1150		
MILES DISCOS	DISQUERIA	HONDURAS 4912		
CENTRO CULTURAL FLOR DEL CEIBO	CENTRO CULTURAL	IRIARTE, GRAL. AV. 3463		
CENTRO CULTURAL TORQUATO TASSO	BAR CULTURAL	DEFENSA 1575		
DEL RIACHUELO ESPACIO DE ARTE	GALERIA DE ARTE	DON PEDRO DE MENDOZA AV. 1887		
EL CAMARIN DE LAS MUSAS	ESPACIO ESCENICO (TEATRO, MUSICA Y DANZA)	BRAVO, MARIO 960		
LA CARPINTERIA TEATRO	ESPACIO ESCENICO (TEATRO, MUSICA Y DANZA)	JAURES, JEAN 858		
ESPACIO CALLEJON	ESPACIO ESCENICO (TEATRO, MUSICA Y DANZA)	HUMAHUACA 3759		
EL EXTRANJERO TEATRO	ESPACIO ESCENICO (TEATRO, MUSICA Y DANZA)	GOMEZ, VALENTIN 3378		
EL KAFKA ESPACIO TEATRAL	ESPACIO ESCENICO (TEATRO, MUSICA Y DANZA)	LAMBARE 866		
PROSCENIO. ESCUELA DE TEATRO MUSICAL.	ESPACIO DE FORMACION (CARRERAS, SEMINARIOS Y TALLERES)	CABILDO AV. 2857		
TEATRO APOLO	ESPACIO ESCENICO (TEATRO, MUSICA Y DANZA)	CORRIENTES AV. 1372		
LA CLAC SALA TEATRAL	ESPACIO ESCENICO (TEATRO, MUSICA Y DANZA)	DE MAYO AV. 1158		
CLUB ALEMAN	ESPACIO DE FORMACION (CARRERAS, SEMINARIOS Y TALLERES)	CORRIENTES AV. 327		
CLUB AMERICANO	CENTRO CULTURAL	VIAMONTE 1133		
NOTORIUS	ESPACIO ESCENICO (TEATRO, MUSICA Y DANZA)	CALLAO AV. 966		
TEATRO EL PICADERO	ESPACIO ESCENICO (TEATRO, MUSICA Y DANZA)	DISCEPOLO, ENRIQUE SANTOS 1857		
NOAVESTRUZ	ESPACIO ESCENICO (TEATRO, MUSICA Y DANZA)	HUMBOLDT 1857		
EL PATIO DE LOS ACTORES	ESPACIO ESCENICO (TEATRO, MUSICA Y DANZA)	LERMA 568		
CAFE VINILO	ESPACIO ESCENICO (TEATRO, MUSICA Y DANZA)	GORRITI 3780		
HASTA TRILCE	ESPACIO ESCENICO (TEATRO, MUSICA Y DANZA)	MAZA 1377		
THELONIUS CLUB	ESPACIO ESCENICO (TEATRO, MUSICA Y DANZA)	SALGUERO, JERONIMO 1884		
CLUB ATLETICO FERNANDEZ FIERRO	ESPACIO ESCENICO (TEATRO, MUSICA Y DANZA)	SANCHEZ DE BUSTAMANTE 764		
NICETO CLUB	ESPACIO ESCENICO (TEATRO, MUSICA Y DANZA)	VEGA, NICETO, CNEL. AV. 5510		
CENTRO CULTURAL DE LA MEMORIA HAROLDO CONTI	CENTRO CULTURAL	DEL LIBERTADOR AV. 8151		
AUDITORIO LOSADA	ESPACIO ESCENICO (TEATRO, MUSICA Y DANZA)	CORRIENTES AV. 1551		
IL BALLO DEL MATTONE	BAR CULTURAL	GORRITI 5737		
LA CIGALE	BAR CULTURAL	25 DE MAYO 597		
TEATRO METROPOLITAN 1 Y 2	ESPACIO DE FORMACION (CARRERAS, SEMINARIOS Y TALLERES)	CORRIENTES AV. 1343		
ASOCIACION LA NUBE, INFANCIA Y CULTURA	CENTRO CULTURAL	NEWBERY, JORGE AV. 3537		
TEATRO EL TINGLADO	ESPACIO ESCENICO (TEATRO, MUSICA Y DANZA)	BRAVO, MARIO 948		
TEATRO PORTEÑO	ESPACIO ESCENICO (TEATRO, MUSICA Y DANZA)	CORRIENTES AV. 1630		
AUDITORIO AMIA	ESPACIO ESCENICO (TEATRO, MUSICA Y DANZA)	PASTEUR 633		
TEATRO DEL VIEJO MERCADO	ESPACIO ESCENICO (TEATRO, MUSICA Y DANZA)	LAVALLE 3177		
AUDITORIO DE LA FUNDACION BEETHOVEN	ESPACIO ESCENICO (TEATRO, MUSICA Y DANZA)	JUNCAL 1264		
GARRICK ARTE Y CULTURA	ESPACIO ESCENICO (TEATRO, MUSICA Y DANZA)	AVELLANEDA AV. 1359		
MUSEO DEL AUTOMOVIL	MUSEO	IRIGOYEN 2265		
BIBLIOTECA DEL DRAGON	BIBLIOTECA	HUALFIN 933		
TADRON TEATRO	ESPACIO ESCENICO (TEATRO, MUSICA Y DANZA)	VEGA, NICETO, CNEL. 4802		
CENTRO CULTURAL LA MOROCHA	CENTRO CULTURAL	TUCUMAN 1735		
LA ESTACION, CASA DE ARTE	ESPACIO DE FORMACION (CARRERAS, SEMINARIOS Y TALLERES)	ZELAYA 3175		
CAFE HOMERO	ESPACIO ESCENICO (TEATRO, MUSICA Y DANZA)	CABRERA, JOSE A. 4946		
COLISEO SPORTS & FUN	BAR CULTURAL	FITZ ROY 2021		
SR. DUNCAN MULTIESPACIO CULTURAL	BAR CULTURAL	RIVADAVIA AV. 3832		
TEATRO EL LABERINTO DEL CICLOPE	ESPACIO ESCENICO (TEATRO, MUSICA Y DANZA)	MEXICO 1718		
TEATRO LA MUECA	ESPACIO ESCENICO (TEATRO, MUSICA Y DANZA)	CORDOBA AV. 5300		
BORIS CLUB DE JAZZ	ESPACIO ESCENICO (TEATRO, MUSICA Y DANZA)	GORRITI 5568		
ESPACIO POLONIA TEATRO	ESPACIO ESCENICO (TEATRO, MUSICA Y DANZA)	FITZ ROY 1477		
INBOCCALUPO	ESPACIO ESCENICO (TEATRO, MUSICA Y DANZA)	ARREDONDO, VIRREY 2495		
ABASTO SOCIAL CLUB	ESPACIO ESCENICO (TEATRO, MUSICA Y DANZA)	YATAY 666		
OVEJA DESCARRIADA!	BAR CULTURAL	ARAOZ 1047		
EL EMERGENTE BAR CLUB	BAR CULTURAL	GALLO 333		
EL QUETZAL CASA CULTURAL	CENTRO CULTURAL	GUATEMALA 4516		
ESPACIO CULTURAL NUESTROS HIJOS. FUNDACION MADRES DE PLAZA DE MAYO	CENTRO CULTURAL	DEL LIBERTADOR AV. 8465		
AL ESCENARIO	ESPACIO ESCENICO (TEATRO, MUSICA Y DANZA)	ARAOZ DE LAMADRID, GREGORIO, GRAL. 1001		
GROOVE	ESPACIO ESCENICO (TEATRO, MUSICA Y DANZA)	SANTA FE AV. 4389		
THE ROXY LIVE	ESPACIO ESCENICO (TEATRO, MUSICA Y DANZA)	VEGA, NICETO, CNEL. AV. 5542		
CINE BELGRANO MULTIPLEX	CINE	VUELTA DE OBLIGADO 2199		
CINE HOYTS ABASTO	CINE	CORRIENTES AV. 3247		
CINE HOYTS DOT	CINE	VEDIA 3626		
CINE VILLAGE CABALLITO	CINE	RIVADAVIA AV. 5071		
CINE VILLAGE RECOLETA	CINE	LOPEZ, VICENTE 2050		
SHOWCASE BELGRANO	CINE	MONROE 1655		
BUENOS AIRES MON AMOUR CINE CLUB	CINE	MAIPU 960		
CASASSA Y LORENZO LIBREROS. SUCURSAL DEVOTO SHOPPING.	LIBRERIA	QUEVEDO 3365		
CATHEDRA JURIDICA	LIBRERIA	LAVALLE 1292		
CERTEZA	LIBRERIA	IRIGOYEN, BERNARDO DE 654		
MARTINA CESPEDES	LIBRERIA	BOLIVAR 660		
LIBRERIA CUSPIDE. SUCURSAL CABILDO.	LIBRERIA	CABILDO AV. 1965		
LIBRERIA CUSPIDE. SUCURSAL CORRIENTES.	LIBRERIA	CORRIENTES AV. 1243		
LIBRERIA CUSPIDE. SUCURSAL CORRIENTES II.	LIBRERIA	CORRIENTES AV. 1316		
LIBRERIA CUSPIDE. SUCURSAL RIVADAVIA.	LIBRERIA	RIVADAVIA AV. 5045		
LIBRERIA CUSPIDE. SUCURSAL SANTA FE.	LIBRERIA	SANTA FE AV. 1818		
LIBRERIA CUSPIDE. SUCURSAL SANTA FE II.	LIBRERIA	SANTA FE AV. 2077		
LIBRERIA CUSPIDE. SUCURSAL FLORIDA.	LIBRERIA	FLORIDA 628		
LIBRERIA CUSPIDE. SUCURSAL GALERIAS PACIFICO.	LIBRERIA	SAN MARTIN 760		
LIBRERIA CUSPIDE. SUCURSAL SUIPACHA.	LIBRERIA	SUIPACHA 764		
LIBRERIA CUSPIDE. SUCURSAL VTE. LOPEZ.	LIBRERIA	LOPEZ, VICENTE 2050		
DANTE ALIGHIERI	LIBRERIA	TUCUMAN 1646		
DE LA MANCHA	LIBRERIA	CORRIENTES AV. 1888		
EL DEBATE	LIBRERIA	PUEYRREDON AV. 731		
LIBROS DEL SOL	LIBRERIA	SUPERI 1411		
DELFOS LIBROS. SUCURSAL CABILDO.	LIBRERIA	CABILDO AV. 3890		
LIBRERIA DESHORAS	LIBRERIA	CORDOBA AV. 1541		
LIBRERIA DICKENS	LIBRERIA	CORRIENTES AV. 1375		
DIDON	LIBRERIA	JUNIN 82		
DIOGENES I	LIBRERIA	MORENO 1767		
DIOGENES II	LIBRERIA	CORRIENTES AV. 1851		
DISTAL LIBROS. SUCURSAL CABILDO.	LIBRERIA	CABILDO AV. 2431		
DISTAL LIBROS. SUCURSAL CORRIENTES.	LIBRERIA	CORRIENTES AV. 921		
DISTAL LIBROS. SUCURSAL RIVADAVIA.	LIBRERIA	RIVADAVIA AV. 4648		
DISTAL LIBROS. SUCURSAL SANTA FE.	LIBRERIA	SANTA FE AV. 3142		
DISTAL LIBROS. SUCURSAL FLORIDA.	LIBRERIA	FLORIDA 249		
DISTAL LIBROS. SUCURSAL FLORIDA II.	LIBRERIA	FLORIDA 436		
DISTAL LIBROS. SUCURSAL RIVADAVIA II.	LIBRERIA	RIVADAVIA AV. 6879		
DISTAL LIBROS. SUCURSAL SCALABRINI ORTIZ.	LIBRERIA	SCALABRINI ORTIZ, RAUL 2518		
DISTAL LIBROS. SUCURSAL LAVALLE.	LIBRERIA	LAVALLE 775		
DISTAL LIBROS. SUCURSAL MEDRANO.	LIBRERIA	MEDRANO AV. 25		
DISTAL LIBROS. SUCURSAL R. FALCON.	LIBRERIA	FALCON, RAMON L.,CNEL. 7145		
MUSEO MANOBLANCA	MUSEO	TABARE 1371		
BIDOU DE LAS LUCES	BAR CULTURAL	PERU 269		
CAMINITO TANGO SHOW	MILONGA Y/O TANGUERIA	VALLE IBERLUCEA DEL, DR. 1151		
MUSEO CULTURAL DEL TANGO	MILONGA Y/O TANGUERIA	MAIPU 666		
TANGO 1921	MILONGA Y/O TANGUERIA	CHACABUCO 454		
SANATA BAR	BAR CULTURAL	SARMIENTO 3501		
MICHELANGELO TANGO	MILONGA Y/O TANGUERIA	BALCARCE 433		
ESQUINA OSVALDO PUGLIESE	MILONGA Y/O TANGUERIA	BOEDO AV. 909		
BOCATANGO	MILONGA Y/O TANGUERIA	BRANDSEN 923		
CLUB PEDRO ECHAGUE	MILONGA Y/O TANGUERIA	PORTELA 836		
CLUB SIN RUMBO	MILONGA Y/O TANGUERIA	TAMBORINI, JOSE PASCUAL 6157		
MANSION DANDY ROYAL	MILONGA Y/O TANGUERIA	PIEDRAS 922		
CLUB GLORIAS ARGENTINAS	MILONGA Y/O TANGUERIA	BRAGADO 6875		
IMAGEN TANGO	MILONGA Y/O TANGUERIA	BALBIN, RICARDO, DR. AV. 4699		
LA CATEDRAL	MILONGA Y/O TANGUERIA	SARMIENTO 4006		
LA INDEPENDENCIA	MILONGA Y/O TANGUERIA	INDEPENDENCIA AV. 572		
LA MILONGUITA (SEDE ARMENIA)	MILONGA Y/O TANGUERIA	ARMENIA 1353		
LA MILONGUITA (SEDE J. NEWBERY)	MILONGA Y/O TANGUERIA	NEWBERY, JORGE 2818		
LA NACIONAL	MILONGA Y/O TANGUERIA	ALSINA, ADOLFO 1465		
LO DE CELIA TANGO	MILONGA Y/O TANGUERIA	HUMBERTO 1 1783		
EL MALEVAJE	MILONGA Y/O TANGUERIA	GARIBALDI 1670		
CLUB GENERAL BELGRANO - PRACTICA COCHABAMBA 444	MILONGA Y/O TANGUERIA	COCHABAMBA 444		
PLAZA BOHEMIA TANGO	MILONGA Y/O TANGUERIA	ALSINA, ADOLFO 2540		
LIBRERIA DE MUJERES	LIBRERIA	RIVAROLA, RODOLFO, DR. 133		
LIBRERIA YENNY. SUCURSAL DEL PARQUE SHOPPING.	LIBRERIA	NAZARRE 3175		
OTRAS LETRAS	LIBRERIA	SOLER 4796		
LIBRERIA MEMORIAS DEL SUBSUELO	LIBRERIA	FLORIDA 835		
TANGO EN EL CENTRO SOCIAL CHICAGO	MILONGA Y/O TANGUERIA	DE LA TORRE, LISANDRO AV. 2319		
MURGUIA LIBROS	LIBRERIA	CORDOBA AV. 2270		
BAR EL CHINO	MILONGA Y/O TANGUERIA	BEAZLEY 3566		
LA CASONA DE FERNANDO	MILONGA Y/O TANGUERIA	CHILE AV. 318		
TACONEANDO EN LA VEREDA DE BEBA	MILONGA Y/O TANGUERIA	BALCARCE 725		
PORTEÑA MIA	MILONGA Y/O TANGUERIA	CHACABUCO 917		
MYTHOS LIBROS	LIBRERIA	GUEMES 4374		
LIBRERIA NORTE	LIBRERIA	LAS HERAS GENERAL AV. 2225		
OCS BOOK SHOP S.R.L.	LIBRERIA	SUPERI 1372		
LIBRERIA PAIDOS	LIBRERIA	LAS HERAS GENERAL AV. 3741		
DE LA RECOLETA GALERIA DE ARTE	GALERIA DE ARTE	AGUERO 2502		
TRANSARTE EMERGENCIAS CULTURALES	GALERIA DE ARTE	DEFENSA 1326		
PARADIGMA LIBROS	LIBRERIA	MAURE 1786		
LA PARAGRAFICA	LIBRERIA	CORDOBA AV. 1785		
PAULINAS	LIBRERIA	LARREA 50		
PARADIGMA LIBROS. SUCURSAL SOLDADO DE LA INDEPENDENCIA.	LIBRERIA	SOLDADO DE LA INDEPENDENCIA 826		
PELUFO LIBRERIAS	LIBRERIA	CORRIENTES AV. 4276		
LIBRERIA DEL PLATA	LIBRERIA	GUIDO 1927		
PLATERO LIBRERIA	LIBRERIA	TALCAHUANO 485		
ANTICUARIA POEMA 20	LIBRERIA	ESMERALDA 869		
PROMETEO LIBROS. SUCURSAL SANTIAGO DEL ESTERO (CS. SOCIALES, UBA).	LIBRERIA	SANTIAGO DEL ESTERO 1029		
PURR LIBROS. SUCURSAL AV. SANTA FE.	LIBRERIA	SANTA FE AV. 2729		
RINCON 9. SUCURSAL RINCON.	LIBRERIA	RINCON 9		
SAN PABLO	LIBRERIA	CALLAO AV. 325		
LIBRERIA SANTA FE. SUCURSAL CALLAO.	LIBRERIA	CALLAO AV. 335		
SBS LIBRERIA INTERNACIONAL. SUCURSAL CORONEL DIAZ.	LIBRERIA	DIAZ, CNEL. AV. 1747		
SBS LIBRERIA INTERNACIONAL. SUCURSAL AV. CORDOBA.	LIBRERIA	CORDOBA AV. 1840		
LIBRERIA LOS 7 LOCOS	LIBRERIA	ESMERALDA 482		
LIBRERIA SIGAL	LIBRERIA	CORRIENTES AV. 2854		
LA TECNOLOGIA	LIBRERIA	MEDRANO AV. 938		
TIEMPOS MODERNOS LIBROS	LIBRERIA	CUBA 1921		
EL TUNEL LIBROS	LIBRERIA	CABILDO AV. 2554		
TURISTICA	LIBRERIA	PARAGUAY 2457		
LIBRERIA DE LA UNIVERSIDAD DEL SALVADOR	LIBRERIA	RODRIGUEZ PE�A 764		
LIBRERIA DE LA UNIVERSIDAD DEL SALVADOR. SUCURSAL PERON.	LIBRERIA	PERON, JUAN DOMINGO, TTE. GENERAL 1818		
LIBRERIA UNIVERSIDAD DE BUENOS AIRES	LIBRERIA	TUCUMAN 1792		
WUSSMAN	GALERIA DE ARTE	VENEZUELA 574		
UTILISIMA SATELITAL	PRODUCTORA AUDIOVISUAL	PIEDRAS 1080		
EDITORIAL UNIVERSIDAD	EDITORIAL	RIVADAVIA AV. 1225		
LEXIS NEXIS-ABELEDO PERROT	LIBRERIA	TALCAHUANO 494		
LA LEY. SUCURSAL TUCUMAN.	EDITORIAL	TUCUMAN 1471		
LA LEY (SAN NICOLAS)	EDITORIAL	VIAMONTE 1534		
CALIBROSCOPIO	EDITORIAL	AGUIRRE 458		
EDITORIAL LONGSELLER SA	EDITORIAL	BLANCO ENCALADA 2388		
EDITORIAL LOSADA (CONGRESO)	EDITORIAL	CORRIENTES AV. 1551		
DISTRIBUIDORA LUMEN S.R.L.	EDITORIAL	VIAMONTE 1674		
EDICIONES MACCHI	EDITORIAL	PACHECO 3190		
MANOS ARTESANAS COMUNICACIONES	EDITORIAL	URUGUAY 1368		
MELOS EDICIONES MUSICALES S.A.	EDITORIAL	PERON, JUAN DOMINGO, TTE. GENERAL 1560		
EDICIONES NOVEDADES EDUCATIVAS - NOVEDUC LIBROS	EDITORIAL	CORRIENTES AV. 4345		
EDICIONES NUEVA TECNICA S.R.L.	EDITORIAL	VIAMONTE 2096		
EDITORIAL PATRIA GRANDE	EDITORIAL	RIVADAVIA AV. 6369		
RUBINZAL - CULZONI EDITORES	EDITORIAL	TALCAHUANO 442		
EDITORIAL SANTA MARIA	EDITORIAL	DIRECTORIO AV. 3755		
L.O.L.A. LITERATURE OF LATIN AMERICA	EDITORIAL	VIAMONTE 976		
ITFS N15 D.E. 01 INSTITUTO DE FORMACION TECNICA	ESPACIO DE FORMACION (CARRERAS, SEMINARIOS Y TALLERES)	FIGUEROA ALCORTA, PRES. AV. 2977		
INSTITUTO DE FORMACION TECNICA SUPERIOR N13 DE N8	ESPACIO DE FORMACION (CARRERAS, SEMINARIOS Y TALLERES)	ALBERDI, JUAN BAUTISTA AV. 163		
"INSTITUTO SUPERIOR DE FORMACION ARTISTICA DE ARTES VISUALES ""MANUEL BELGRANO"""	ESPACIO DE FORMACION (CARRERAS, SEMINARIOS Y TALLERES)	VILLAFAÃ‘E, WENCESLAO 1342		
INSTITUTO DE FORMACION TECNICA SUPERIOR N12 - IFTS	ESPACIO DE FORMACION (CARRERAS, SEMINARIOS Y TALLERES)	VIAMONTE 869		
"BACHILLERATO CON ORIENTACION ARTISTICA N 1 DE 08 ""ANTONIO BERNI"""	ESPACIO DE FORMACION (CARRERAS, SEMINARIOS Y TALLERES)	QUITO 4045		
"BACHILLERATO CON ORIENTACION ARTISTICA N 4 DE 6 ""XUL SOLAR"""	ESPACIO DE FORMACION (CARRERAS, SEMINARIOS Y TALLERES)	JUJUY AV. 150		
"INSTITUTO SUPERIOR DE FORMACION ARTISTICA DE DANZAS ""JORGE DONN"""	ESPACIO DE FORMACION (CARRERAS, SEMINARIOS Y TALLERES)	MAGARIÃ‘OS CERVANTES, A. 5068		
LIBRERIA UNIVERSITARIA DE BUENOS AIRES	LIBRERIA	TUCUMAN 1792		
URSINO TEXTOS MEDICOS	LIBRERIA	ALVEAR, MARCELO T. DE 2125		
VOCES DEL SUR	LIBRERIA	AZCUENAGA 720		
VUELVO AL SUR	LIBRERIA	LA RIOJA 2127		
LIBRERIA Y SU DOBLE	LIBRERIA	RODRIGUEZ PE�A 698		
LIBRERIA YENNY. SUCURSAL SALGUERO.	LIBRERIA	SALGUERO, JERONIMO 3172		
"INSTITUTO SUPERIOR DE FORMACION ARTISTICA DE CERAMICA ""FERNANDO ARRANZ"""	ESPACIO DE FORMACION (CARRERAS, SEMINARIOS Y TALLERES)	MAGARIÃ‘OS CERVANTES, A. 5068		
"ESCUELA DE DANZAS ""CURSO JUVENIL"" N6 DE 7"	ESPACIO DE FORMACION (CARRERAS, SEMINARIOS Y TALLERES)	PRINGLES 263		
"ESCUELA DE DANZAS N1 ""NELLY RAMICONE"""	ESPACIO DE FORMACION (CARRERAS, SEMINARIOS Y TALLERES)	FONROUGE 711		
FACULTAD DE CIENCIAS SOCIALES UBA (SEDE CONSTITUCION)	ESPACIO DE FORMACION (CARRERAS, SEMINARIOS Y TALLERES)	SANTIAGO DEL ESTERO 1029		
ESCUELA ARGENTINA DE TANGO (SEDE TALCAHUANO)	ESPACIO DE FORMACION (CARRERAS, SEMINARIOS Y TALLERES)	TALCAHUANO 1052		
ESCUELA ARGENTINA DE TANGO (SEDE CENTRO)	ESPACIO DE FORMACION (CARRERAS, SEMINARIOS Y TALLERES)	VIAMONTE Y SAN MARTIN		
FACULTAD DE FILOSOFIA Y LETRAS	ESPACIO DE FORMACION (CARRERAS, SEMINARIOS Y TALLERES)	PUAN 480		
"INSTITUTO SUPERIOR DE FORMACION ARTISTICA DE ARTES VISUALES ""ROGELIO YRURTIA"""	ESPACIO DE FORMACION (CARRERAS, SEMINARIOS Y TALLERES)	ALBERDI, JUAN BAUTISTA AV. 4754		
ESCUELA PROFESIONAL DE CINE ELISEO SUBIELA	ESPACIO DE FORMACION (CARRERAS, SEMINARIOS Y TALLERES)	CUBA 2665		
ESCUELA DE CERAMICA N1 DE N2	ESPACIO DE FORMACION (CARRERAS, SEMINARIOS Y TALLERES)	BULNES 45		
"ESCUELA DE BELLAS ARTES DE N4 ""MANUEL BELGRANO"" ESCUELA MEDIA"	ESPACIO DE FORMACION (CARRERAS, SEMINARIOS Y TALLERES)	VILLAFAÃ‘E, WENCESLAO 1342		
"ESCUELA DE BELLAS ARTES DE N13 ""ROGELIO YRURTIA"" BACHILLER"	ESPACIO DE FORMACION (CARRERAS, SEMINARIOS Y TALLERES)	ALBERDI, JUAN BAUTISTA AV. 4754		
"INSTITUTO SUPERIOR DE ARTE ""TEATRO COLON"""	ESPACIO DE FORMACION (CARRERAS, SEMINARIOS Y TALLERES)	CERRITO 628		
"INSTITUTO SUPERIOR DE FORMACION ARTISTICA DE DANZAS ""NELLY RAMICONE"""	ESPACIO DE FORMACION (CARRERAS, SEMINARIOS Y TALLERES)	PIERES 258		
"INSTITUTO SUPERIOR DE FORMACION ARTISTICA DE MUSICA ""JUAN PEDRO ESNAOLA"""	ESPACIO DE FORMACION (CARRERAS, SEMINARIOS Y TALLERES)	GIRARDOT 1946		
UNIVERSIDAD NACIONAL DE GENERAL SAN MARTIN	ESPACIO DE FORMACION (CARRERAS, SEMINARIOS Y TALLERES)	PARANA 145		
MILONGA CHE FLORES	MILONGA Y/O TANGUERIA	ARCE 235		
CENTRO DE ORGANIZADORES DE EVENTOS (COE)	ESPACIO DE FORMACION (CARRERAS, SEMINARIOS Y TALLERES)	PARAGUAY 1589		
CENTRO DE INVESTIGACIONES CINEMATOGRAFICAS (CIC)	ESPACIO DE FORMACION (CARRERAS, SEMINARIOS Y TALLERES)	MATIENZO, BENJAMIN, TENIENTE 2571		
CENTRO ARGENTINO DE ESTUDIO DE MODAS (CAEM)	ESPACIO DE FORMACION (CARRERAS, SEMINARIOS Y TALLERES)	ALVAREZ, JULIAN 1605		
BUENOS AIRES COMUNICACION	ESPACIO DE FORMACION (CARRERAS, SEMINARIOS Y TALLERES)	BULNES 1350		
CENTRO DE ARTE Y TECNOLOGIA (CEARTEC)	ESPACIO DE FORMACION (CARRERAS, SEMINARIOS Y TALLERES)	FRANCO 3057		
ASOCIACION PROFESIONALES DE MEDIOS	ESPACIO DE FORMACION (CARRERAS, SEMINARIOS Y TALLERES)	SAN MARTIN 491		
"ESCUELA DE DANZAS ""REINA REECH"""	ESPACIO DE FORMACION (CARRERAS, SEMINARIOS Y TALLERES)	MENDOZA 2032		
MORA GODOY TANGO EVENTOS	ESPACIO DE FORMACION (CARRERAS, SEMINARIOS Y TALLERES)	PUEYRREDON AV. 1090		
NUEVO ESTUDIO LA ESQUINA	MILONGA Y/O TANGUERIA	SARMIENTO 722		
ORT (ALMAGRO)	ESPACIO DE FORMACION (CARRERAS, SEMINARIOS Y TALLERES)	YATAY 240		
ORT (NUÑEZ)	ESPACIO DE FORMACION (CARRERAS, SEMINARIOS Y TALLERES)	DEL LIBERTADOR AV. 6796		
ETER	ESPACIO DE FORMACION (CARRERAS, SEMINARIOS Y TALLERES)	ACEVEDO 262		
"ESCUELA DE DISEÑO Y MOLDERIA ""FERNANDA GONZALEZ"""	ESPACIO DE FORMACION (CARRERAS, SEMINARIOS Y TALLERES)	PUEYRREDON, HONORIO, DR. AV. 876		
"ESCUELA DE DISEÑO Y MODA ""DONATO DELEGO"""	ESPACIO DE FORMACION (CARRERAS, SEMINARIOS Y TALLERES)	SUCRE, ANTONIO JOSE DE, MCAL. 2371		
ESCUELA DA VINCI - ESCUELA DE ARTE MULTIMEDIA	ESPACIO DE FORMACION (CARRERAS, SEMINARIOS Y TALLERES)	CORRIENTES AV. 2037		
UNIVERSIDAD DE CIENCIAS EMPRESARIALES Y SOCIALES	ESPACIO DE FORMACION (CARRERAS, SEMINARIOS Y TALLERES)	PARAGUAY 1401		
LA ACADEMIA DE TANGO DE SUSANA MILLER Y MARIA PLAZAOLA	MILONGA Y/O TANGUERIA	RIOBAMBA 416		
UNIVERSIDAD DEL SALVADOR - FACULTAD DE CIENCIAS DE LA EDUCACION Y LA COMUNICACION SOCIAL	ESPACIO DE FORMACION (CARRERAS, SEMINARIOS Y TALLERES)	CALLAO AV. 835		
TANGO ESCUELA CARLOS COPELLO	MILONGA Y/O TANGUERIA	ANCHORENA, TOMAS MANUEL DE, DR. 575		
UNIVERSIDAD DEL SALVADOR - FACULTAD DE CIENCIAS ECONOMICAS	ESPACIO DE FORMACION (CARRERAS, SEMINARIOS Y TALLERES)	ALVEAR, MARCELO T. DE 1335		
ASOCIACION ARGENTINA DE PUBLICIDAD	ESPACIO DE FORMACION (CARRERAS, SEMINARIOS Y TALLERES)	SANCHEZ DE BUSTAMANTE 106		
UNIVERSIDAD DEL SALVADOR - FACULTAD DE FILOSOFIA Y LETRAS	ESPACIO DE FORMACION (CARRERAS, SEMINARIOS Y TALLERES)	RODRIGUEZ PE�A 670		
UNIVERSIDAD DE PALERMO - FACULTAD DE CIENCIAS SOCIALES - DISEÑO Y COMUNICACION	ESPACIO DE FORMACION (CARRERAS, SEMINARIOS Y TALLERES)	CORDOBA AV. 3501		
UNIVERSIDAD DEL CINE - FACULTAD DE CINEMATOGRAFIA Y CIENCIAS DE LA EDUCACION	ESPACIO DE FORMACION (CARRERAS, SEMINARIOS Y TALLERES)	GIUFFRA, JOSE M.,DR. 330		
UNIVERSIDAD MAIMONIDES ESCUELA DE HUMANIDADES	ESPACIO DE FORMACION (CARRERAS, SEMINARIOS Y TALLERES)	HIDALGO 775		
"CONSUDEC - PROFESORADOS ""SEPTIMO WALSH"""	ESPACIO DE FORMACION (CARRERAS, SEMINARIOS Y TALLERES)	ESMERALDA 759		
LA ESCUELA DEL TANGO	MILONGA Y/O TANGUERIA	SAN JOSE 364		
UADE - FACULTAD DE CIENCIAS DE LA COMUNICACION Y DISEÑO	ESPACIO DE FORMACION (CARRERAS, SEMINARIOS Y TALLERES)	LIMA 775		
MUSICARTE XXI	ESPACIO DE FORMACION (CARRERAS, SEMINARIOS Y TALLERES)	11 DE SEPTIEMBRE DE 1888 988		
ESCUELA NACIONAL DE MUSEOLOGIA	ESPACIO DE FORMACION (CARRERAS, SEMINARIOS Y TALLERES)	MORENO 711		
"INSTITUTO SUPERIOR DE LETRAS ""EDUARDO MALLEA"""	ESPACIO DE FORMACION (CARRERAS, SEMINARIOS Y TALLERES)	ARREDONDO, VIRREY 2416		
TEA IMAGEN	ESPACIO DE FORMACION (CARRERAS, SEMINARIOS Y TALLERES)	URIBURU JOSE E., PRES. 353		
RADIO TEA	ESPACIO DE FORMACION (CARRERAS, SEMINARIOS Y TALLERES)	LAVALLE 2258		
"INSTITUTO SUPERIOR ""DANTE ALIGHIERI"""	ESPACIO DE FORMACION (CARRERAS, SEMINARIOS Y TALLERES)	TUCUMAN 1646		
IMAGEN CAMPUS	ESPACIO DE FORMACION (CARRERAS, SEMINARIOS Y TALLERES)	SALTA 239		
TALLER IMAGEN	ESPACIO DE FORMACION (CARRERAS, SEMINARIOS Y TALLERES)	SARMIENTO 2210		
ESCUELA MOTIVARTE	ESPACIO DE FORMACION (CARRERAS, SEMINARIOS Y TALLERES)	MALABIA 1141		
ESCUELA ARGENTINA DE FOTOGRAFIA	ESPACIO DE FORMACION (CARRERAS, SEMINARIOS Y TALLERES)	CAMPOS SALLES 2155		
ABM	ESPACIO DE FORMACION (CARRERAS, SEMINARIOS Y TALLERES)	ALVEAR, MARCELO T. DE 1155		
INSTITUTO EDUCATIVO ARGENTINO	ESPACIO DE FORMACION (CARRERAS, SEMINARIOS Y TALLERES)	RIVADAVIA AV. 11444		
ISPRA INSTITUTO SUPERIOR DE PROTOCOLO DE LA REPUBLICA ARGENTINA	ESPACIO DE FORMACION (CARRERAS, SEMINARIOS Y TALLERES)	RIOBAMBA 1059		
"INSTITUTO DE BELLAS ARTES ""BEATO ANGELICO"""	ESPACIO DE FORMACION (CARRERAS, SEMINARIOS Y TALLERES)	ESTADOS UNIDOS 1153		
"INSTITUTO DE DISEÑO ESCENICO ""SAULO BENAVENTE"""	ESPACIO DE FORMACION (CARRERAS, SEMINARIOS Y TALLERES)	MORENO 3326		
ESCUELA SUPERIOR DE MUSICA (SADEM)	ESPACIO DE FORMACION (CARRERAS, SEMINARIOS Y TALLERES)	BELGRANO AV. 3655		
INSTITUTO UNIVERSITARIO ESEADE	ESPACIO DE FORMACION (CARRERAS, SEMINARIOS Y TALLERES)	URIARTE 2472		
ISEC	ESPACIO DE FORMACION (CARRERAS, SEMINARIOS Y TALLERES)	VIAMONTE 2020		
INSTITUTO SUPERIOR DEL PROFESORADO (COSAL)	ESPACIO DE FORMACION (CARRERAS, SEMINARIOS Y TALLERES)	YAPEYU 197		
UNIVERSIDAD POPULAR MADRES DE PLAZA DE MAYO	ESPACIO DE FORMACION (CARRERAS, SEMINARIOS Y TALLERES)	YRIGOYEN, HIPOLITO AV. 1584		
NUEVA ESCUELA	ESPACIO DE FORMACION (CARRERAS, SEMINARIOS Y TALLERES)	CALLAO AV. 67		
"ESCUELA DE FOTOGRAFIA CREATIVA ""ANDY GOLDSTEIN"""	ESPACIO DE FORMACION (CARRERAS, SEMINARIOS Y TALLERES)	GALLO 1215		
"ESCUELA DE DANZAS N1 ""AIDA VICTORIA MASTRAZZI"""	ESPACIO DE FORMACION (CARRERAS, SEMINARIOS Y TALLERES)	ESMERALDA 285		
ESCUELA SUPERIOR DE PUBLICIDAD COMUNICACION Y ARTES VISUALES	ESPACIO DE FORMACION (CARRERAS, SEMINARIOS Y TALLERES)	PARAGUAY 1896		
INSTITUTO DE INVESTIGACION Y PERFECCIONAMIENTO IDIP	ESPACIO DE FORMACION (CARRERAS, SEMINARIOS Y TALLERES)	URUGUAY 345		
LA SUISSE-CEPEC	ESPACIO DE FORMACION (CARRERAS, SEMINARIOS Y TALLERES)	CORRIENTES AV. 1996		
INSTITUTO SUPERIOR OCTUBRE ISO (SUTERH)	ESPACIO DE FORMACION (CARRERAS, SEMINARIOS Y TALLERES)	VENEZUELA 356		
CIEVYC CINE	ESPACIO DE FORMACION (CARRERAS, SEMINARIOS Y TALLERES)	COCHABAMBA 868		
"ESCUELA MUSEO DE BELLAS ARTES ""GRAL URQUIZA"" N 1 DE 12"	ESPACIO DE FORMACION (CARRERAS, SEMINARIOS Y TALLERES)	YERBAL 2370		
INSTITUTO UNIVERSITARIO NACIONAL DE ARTE	ESPACIO DE FORMACION (CARRERAS, SEMINARIOS Y TALLERES)	AZCUENAGA 1129		
INSTITUTO UNIVERSITARIO NACIONAL DE ARTE - DEPTO DE ARTES DEL MOVIMIENTO	ESPACIO DE FORMACION (CARRERAS, SEMINARIOS Y TALLERES)	SANCHEZ DE LORIA 443		
INSTITUTO UNIVERSITARIO NACIONAL DE ARTE - DEPTO DE ARTES DRAMATICOS	ESPACIO DE FORMACION (CARRERAS, SEMINARIOS Y TALLERES)	FRENCH 3614		
INSTITUTO UNIVERSITARIO NACIONAL DE ARTE - AREA DE ARTES MULTIMEDIALES	ESPACIO DE FORMACION (CARRERAS, SEMINARIOS Y TALLERES)	YATAY 843		
INSTITUTO UNIVERSITARIO NACIONAL DE ARTE - AREA DE CRITICA DE ARTES	ESPACIO DE FORMACION (CARRERAS, SEMINARIOS Y TALLERES)	MITRE, BARTOLOME 1869		
LIBRERIA YENNY. SUCURSAL AV. CABILDO.	LIBRERIA	CABILDO AV. 1978		
INSTITUTO UNIVERSITARIO NACIONAL DE ARTE - AREA DE ARTES AUDIOVISUALES	ESPACIO DE FORMACION (CARRERAS, SEMINARIOS Y TALLERES)	ROCAMORA 4141		
LIBRERIA YENNY. SUCURSAL AEROPUERTO.	LIBRERIA	OBLIGADO RAFAEL, AV.COSTANERA Y SARMIENTO AV.		
LIBRERIA YENNY. SUCURSAL AV. DEL LIBERTADOR.	LIBRERIA	DEL LIBERTADOR AV. 740		
LIBRERIA JURIDICA YNY	LIBRERIA	LAVALLE 1567		
JUPITER LIBRERIA JURIDICO NOTARIAL	LIBRERIA	LAVALLE 1569		
LIBRERIA DEL JURISTA	LIBRERIA	TALCAHUANO 427		
KEHOT LIBROS & JUDAICA	LIBRERIA	CABRERA, JOSE A. 3102		
KEL EDICIONES. SUCURSAL CONDE.	LIBRERIA	CONDE 1990		
KELL EDICIONES. SUCURSAL M. T. DE ALVEAR.	LIBRERIA	ALVEAR, MARCELO T. DE 1369		
EDITORIAL KIER	LIBRERIA	SANTA FE AV. 1260		
LA LECTURA	LIBRERIA	TUCUMAN 1425		
LETRA VIVA LIBROS	LIBRERIA	DIAZ, CNEL. AV. 1837		
LIBRERIA - EDITORIAL HISTORICA EMILIO J. PERROT	LIBRERIA	AZCUENAGA 1846		
LIBRERIA LEGAL	LIBRERIA	RIOBAMBA 460		
EL LIBRO FRANCES	LIBRERIA	ESMERALDA 861		
LIBRERIA DEL MALBA	LIBRERIA	FIGUEROA ALCORTA, PRES. AV. 3415		
LIBRERIA MARISTA	LIBRERIA	CALLAO AV. 226		
LIBRERIA DEL MARMOL	LIBRERIA	LAVALLE 2015		
MS LIBROS	LIBRERIA	FLORIDA 835		
FERMIN BELLI	DISQUERIA	RIVADAVIA AV. 4930		
LON RECORDS S.R.L.	DISQUERIA	CABILDO AV. 2280		
MAGGI	DISQUERIA	CABILDO AV. 2554		
LASER COMPACT DISC	DISQUERIA	CORRIENTES AV. 753		
LEF	DISQUERIA	TRIUNVIRATO AV. 4673		
KASHMIR MUSIC	DISQUERIA	RIVADAVIA AV. 4900		
LA CUEVA MUSICAL	DISQUERIA	LAVALLE 744		
PICCOLO Y SAXO	DISQUERIA	SANTA FE AV. 3591		
JUAN C. CIGARROA	DISQUERIA	FLORIDA 537		
RECORD SHOP	DISQUERIA	SUAREZ, JOSE LEON 92		
RATS RECORDS TATOO	DISQUERIA	LAVALLE 669		
ROCK SHOW	DISQUERIA	CABILDO AV. 2280		
ROCK AND BILLY	DISQUERIA	SARMIENTO 1249		
WORLD MUSIC	DISQUERIA	PARANA 525		
STROBE RECORDS	DISQUERIA	CABILDO AV. 2280		
SILBANDO DISCOS COMPACTOS	DISQUERIA	CORRIENTES AV. 1543		
EL AGUJERITO	DISQUERIA	MAIPU 971		
COOL MUSIC	DISQUERIA	CALLAO AV. 687		
SON DE AZUCAR	DISQUERIA	GALLO 251		
CUATRO DISQUERIAS	DISQUERIA	LAVALLE 985		
ANTHOLOGY	DISQUERIA	SANTA FE AV. 1670		
ANDREA L. CABRERA	DISQUERIA	SANTA FE AV. 1670		
BRANCA JORGE D	DISQUERIA	LAVALLE 914		
CALVO Y RODRIGUEZ JOSE ANTONIO	DISQUERIA	LAVALLE 809		
CANTACLARO	DISQUERIA	CORRIENTES AV. 1217		
CARLOS CORONATI	DISQUERIA	CORRIENTES AV. 1644		
CARMEN A. AMADO	DISQUERIA	CUZCO 40		
CD DISQUERIA	DISQUERIA	CORRIENTES AV. 1274		
CENTOMAR S.A.	DISQUERIA	LIBERTAD 877		
CLUB DE TANGO	DISQUERIA	PARANA 123		
COMPANIA ERMISUL S.A.	DISQUERIA	CABILDO AV. 2040		
DANIEL H. GONZALEZ	DISQUERIA	FLORIDA 971		
IOVANETTI OSCAR M.	DISQUERIA	CORRIENTES AV. 1246		
GERSZTEIN GUILLERMO D.	DISQUERIA	ENTRE RIOS AV. 879		
FASICARO GUSTAVO	DISQUERIA	ARENALES 3337		
FABELA DISCOS	DISQUERIA	PELLEGRINI, CARLOS 155		
ESPECIAL RECORD S.H.	DISQUERIA	RODRIGUEZ PE�A 122		
ELVIS SHOP	DISQUERIA	FLORIDA 520		
DVD PRODUCCIONES FONOGRAFICAS S.A:	DISQUERIA	CERVIÃ‘O AV. 3375		
TANGO QUEER	MILONGA Y/O TANGUERIA	PERU 571		
MAYORAL Y ELSA MARIA	MILONGA Y/O TANGUERIA	CALLAO AV. 1078		
SALON G.O.N	MILONGA Y/O TANGUERIA	PAVON AV. 3916		
"MUSEO ""BERNARDO A. HOUSSAY"" DE HISTORIA DE LA CIENCIA Y LA TECNOLOGIA"	MUSEO	VIAMONTE 2790		
TANGO EN GEBA	MILONGA Y/O TANGUERIA	MITRE, BARTOLOME 1149		
JUAN ALBERTO COIFFEUR	DISQUERIA	GUIDO 1998		
CULB VILLA MALCOLM	MILONGA Y/O TANGUERIA	CORDOBA AV. 5064		
INSTITUTO DEL CEMENTO PORTLAND ARGENTINO	ARCHIVO	SAN MARTIN 1137		
CLUB EXPERIMENTAL DE TANGO ARTE	MILONGA Y/O TANGUERIA	VENEZUELA 857		
CIRCULO SOCIAL MARIANO ACOSTA	MILONGA Y/O TANGUERIA	ACOSTA, MARIANO AV. 13		
EL PIAL	MILONGA Y/O TANGUERIA	FALCON, RAMON L.,CNEL. 2750		
LA UNIVERSIDAD DEL TANGO	ESPACIO DE FORMACION (CARRERAS, SEMINARIOS Y TALLERES)	AGRELO 3231		
LA HUELLA	ESPACIO ESCENICO (TEATRO, MUSICA Y DANZA)	GUARDIA VIEJA 3802		
BIBLIOTECA DEL DOCENTE	BIBLIOTECA	ENTRE RIOS AV. 1349		
"BANCO CENTRAL DE LA REPUBLICA ARGENTINA - BIBLIOTECA ""RAUL PRESBICH"""	BIBLIOTECA	RECONQUISTA 250		
"INSTITUTO DE INVESTIGACIONES MEDICAS ""ALFREDO LANARI"""	BIBLIOTECA	COMBATIENTES DE MALVINAS AV. 3150		
GRUPO ESPELEOLOGICO ARGENTINO	BIBLIOTECA	HEREDIA 426		
BIBLIOTECA COLEGIO NACIONAL BUENOS AIRES	BIBLIOTECA	BOLIVAR 263		
CENTRO DE INFORMACION FUNDACION ESTIMULO A LA VIDA	BIBLIOTECA	PALPA 3307		
LABORATORIO ROUX OCEFA	BIBLIOTECA	MEDINA 138		
"BIBLIOTECA ""ISIDORO RUIZ MORENO"" ESCUELA DE GUERRA NAVAL"	BIBLIOTECA	DEL LIBERTADOR AV. 8071		
BIBLIOTECA LABINCA S.A.	BIBLIOTECA	CRAMER 4130		
BIBLIOTECA Y MAPOTECA SERVICIO GEOGRAFICO MILITAR	BIBLIOTECA	CABILDO AV. 381		
BIBLIOTECA DE LA ACADEMIA NACIONAL DE GEOGRAFIA	BIBLIOTECA	CABILDO AV. 381		
"BIBLIOTECA ""GENERAL BELGRANO"" ESCUELA SUPERIOR DE GUERRA ""TENIENTE GENERAL LUIS M. CAMPOS"""	BIBLIOTECA	MIGUELETES 560		
"BIBLIOTECA DEL HOSPITAL MILITAR CENTRAL ""CIRCULAR MILITAR DR. COSME ARGERICH"""	BIBLIOTECA	CAMPOS, LUIS M. AV. 726		
BIBLIOTECA CENTRO DE INVESTIGACIONES EN ANTROPOLOGIA Y FILOSOFICA Y CULTURAL	BIBLIOTECA	LACROZE, FEDERICO AV. 2100		
INSTITUTO DE ASTRONOMIA Y FISICA DEL ESPACIO	BIBLIOTECA	GUIRALDES, INT. 2620		
CENTRO DE INVESTIGACIONES BIOENERGETICAS	BIBLIOTECA	PARAGUAY 2155		
"CENTRO DE DOCUMENTACION ""DR. SERGIO D"" CONF. MEDICA REPUBLICA ARGENTINA"	BIBLIOTECA	BELGRANO AV. 1235		
BIBLIOTECA CENTTRO LINCOLN INSTITUTO CULTURAL ARGENTINO NORTEAMERICANO	BIBLIOTECA	MAIPU 686		
BIBLIOTECA AIDIS ASOCIACION INTERAMERICANA DE INGENIERIA SANITARIA Y CIENCIAS DEL AMBIENTE	BIBLIOTECA	BELGRANO AV. 1580		
FUNNY BOOKS	LIBRERIA	CIUDAD DE LA PAZ 2602		
LIBRERIA EL GAUCHO. SUCURSAL BOYACA.	LIBRERIA	BOYACA 1538		
LIBRERIA EL GAUCHO. SUCURSAL NEUNQUEN.	LIBRERIA	NEUQUEN 765		
GAMBITO DE ALFIL	LIBRERIA	BONIFACIO, JOSE 1402		
EL GATO ESCALADO LIBROS	LIBRERIA	INDEPENDENCIA AV. 3548		
EL TUNEL DE BUENOS AIRES	LIBRERIA	DE MAYO AV. 767		
LIBRERIA ENSAYO	LIBRERIA	LAVALLE 528		
EL ESCRIBA	LIBRERIA	BALCARCE 1053		
EIFFEL LIBRES	LIBRERIA	CORDOBA AV. 960		
ESTARI LIBROS	LIBRERIA	VIAMONTE 2058		
CALESITA PLAZA ALMAGRO	CALESITA	BULNES Y SARMIENTO		
CALESITA DEL SPINETTO	CALESITA	ALSINA, ADOLFO Y MATHEU		
CALESITA DE DON PEPE	CALESITA	HERRERA Y BRANDSEN		
LA CALESITA DE ANTONIO	CALESITA	IRIARTE, GRAL. AV. Y LUZURIAGA		
CALESITA ESTACION BELGRANO R	CALESITA	JURAMENTO 3200		
CALESITA DE LA PLAZA REPUBLICA DE MEXICO	CALESITA	LA PAMPA Y FIGUEROA ALCORTA, PRES. AV.		
CALESITA DE PARQUE RIVADAVIA	CALESITA	ROSARIO Y BEAUCHEF		
CALESITA JOSE DE PLAZA IRLANDA	CALESITA	NEUQUEN Y ALVAREZ, DONATO, TTE. GRAL.		
CALESITA ESTACION CABALLITO	CALESITA	ROJAS Y BACACAY		
LA CALESITA DE CARLITOS	CALESITA	GALLARDO, ANGEL AV. Y PATRICIAS ARGENTINAS AV.		
LA CALESITA DE PARQUE LOS ANDES	CALESITA	ARENAL, CONCEPCION Y CORRIENTES AV.		
CALESITA DEL PARQUE INFANTIL DON JOSE	CALESITA	ALVAREZ JONTE AV. 4767		
LA CALESITA DE COLEGIALES	CALESITA	LACROZE, FEDERICO AV. 2782		
CALESITA EL PATO	CALESITA	ENTRE RIOS AV. 1056		
CALESITA PEKAS	CALESITA	GAONA AV. 3036		
CALESITA DE LA PLAZA MISERICORDIA	CALESITA	LAUTARO Y BILBAO, FRANCISCO		
CALESITA DE LA PLAZA GENERAL PUEYRREDON	CALESITA	YERBAL Y ARTIGAS, JOSE GERVASIO, GRAL.		
CALESITA DE LA ESTACION FLORESTA	CALESITA	SEGUROLA AV. Y FLORES, VENANCIO, GRAL.		
LA CALESITA DE DON LUIS	CALESITA	FALCON, RAMON L.,CNEL. AV. 5990		
CALESITA EL GATO DEL POLIDEPORTIVO NUEVA CHICAGO	CALESITA	DIRECTORIO AV. Y DE LA TORRE, LISANDRO AV.		
CALESITA MI SUEÑO DE LA PLAZA SALABERRY	CALESITA	ALBERDI, JUAN BAUTISTA AV. Y PILAR		
CARROUSEL DE LOS NIÑOS DE LA PLAZA DEL CONGRESO	CALESITA	YRIGOYEN, HIPOLITO Y SAENZ PE�A, LUIS, PRES.		
CALESITA PEDRITO DE LA PLAZA POMPEYA	CALESITA	TRAFUL Y SAENZ AV.		
CALESITA DE LA PLAZA BALCARCE	CALESITA	VUELTA DE OBLIGADO Y JARAMILLO		
CALESITA DEL JARDIN ZOOLOGICO	CALESITA	DEL LIBERTADOR AV. Y SARMIENTO AV.		
CALESITA DE LA PLAZA UNION LATINOAMERICANA	CALESITA	COSTA RICA Y MEDRANO		
CALESITA DEL PARQUE 3 DE FEBRERO	CALESITA	DEL LIBERTADOR AV. Y REPUBLICA DE LA INDIA		
LA CALESITA DE PEDRITO DE PARQUE LAS HERAS	CALESITA	DIAZ, CNEL. AV. Y LAS HERAS GENERAL AV.		
CALESITA DE LA PLAZA CAMPAÑA DEL DESIERTO	CALESITA	MALABIA Y NICARAGUA		
QUEEN CARROUSEL	CALESITA	FIGUEROA ALCORTA, PRES. AV. Y SALGUERO, JERONIMO		
CALESITA JUAN CARLOS DE LA PLAZA REPUBLICA DE BOLIVIA	CALESITA	DEL LIBERTADOR AV. Y OLLEROS AV.		
CALESITA DE PARQUE AVELLANEDA	CALESITA	DIRECTORIO AV. Y LACARRA		
LA CALESITA DE TATIN DEL PQUE. CHACABUCO	CALESITA	ASAMBLEA AV. Y MIRO		
LA CALESITA DE PARQUE PATRICIOS	CALESITA	CASEROS AV. Y PEPIRI		
LA CALESITA DE DANIEL DE LA PLAZA TTE. GRAL. EMILIO MITRE	CALESITA	CANTILO Y PACHECO DE MELO, JOSE ANDRES		
CARROUSEL CLASICO	CALESITA	POSADAS Y LIBERTAD		
CALESITA DEL PARQUE SAAVEDRA	CALESITA	GARCIA DEL RIO Y CONDE		
CALESITA PLAZA ESTE DE LA ESTACION SAAVEDRA	CALESITA	BALBIN, RICARDO, DR. AV. Y PLAZA		
CALESITA DE LA PLAZA MARTIN FIERRO	CALESITA	BARCALA Y URQUIZA, GRAL.		
CALESITA DE PARQUE LEZAMA	CALESITA	DEFENSA Y FINOCHIETTO ENRIQUE DR.		
CALESITA DE LA ALEGRIA DE LA PLAZA ARISTOBULO DEL VALLE	CALESITA	CAMPANA Y SASTRE, MARCOS		
LA CALESITA DE DEVOTO	CALESITA	NUEVA YORK 4050		
LA CALESITA DE PASCUALITO DE LA PLAZA SAENZ PEÑA	CALESITA	LAMAS, ANDRES Y ESCALADA DE SAN MARTIN, R.		
CALESITA STELLA MARIS	CALESITA	SOLDADO DE LA FRONTERA AV. Y OLASCOAGA, MANUEL JOSE, CNEL.		
CALESITA A LOS SUEÑOS DE LOS NIÑOS DE LA PLAZA UNIDAD NACIONAL	CALESITA	MURGUIONDO Y GALLO, DELFIN		
CALESITA DE LA PLAZA 25 DE AGOSTO	CALESITA	CHARLONE Y 14 DE JULIO		
LA CALESITA DE LEONARDO	CALESITA	BEIRO, FRANCISCO AV. 5340		
CALESITA EL CAPRICHO	CALESITA	FERNANDEZ DE LA CRUZ, F., GRAL. AV. Y PIEDRA BUENA AV.		
EL ESCONDITE	LIBRERIA	GUEMES 3877		
LA CALESITA DE LA PLAZA 1 DE MAYO	CALESITA	YRIGOYEN, HIPOLITO Y PASCO		
LIBROS FRIEDENTHAL	LIBRERIA	PERON, JUAN DOMINGO, TTE. GENERAL 1597		
LIBRERIA EL FORO	LIBRERIA	LAVALLE 1362		
FLORENTINO LIBROS	LIBRERIA	PARRAL 93		
FEDRO	CENTRO CULTURAL	CALVO, CARLOS 578		
EL FARO DEL FIN DEL MUNDO	LIBRERIA	LIBERTAD 1240		
LIBRERIA FAMS	LIBRERIA	CORDOBA AV. 2208		
LIBRERIA LA FACULTAD	LIBRERIA	INDEPENDENCIA AV. 3065		
EL EXTRANJERO LIBROS Y CINE	LIBRERIA	OLLEROS 4128		
LIBRERIA DEL INSTITUTO	LIBRERIA	RODRIGUEZ PE�A 1054		
LIBRERIA HUEMUL	LIBRERIA	SANTA FE AV. 2237		
LIBRERIA HERNANDEZ. SUCURSAL CORRIENTES II.	LIBRERIA	CORRIENTES AV. 1311		
LIBRERIA HERNANDEZ. SUCURSAL CORRIENTES.	LIBRERIA	CORRIENTES AV. 1436		
LIBRERIA HELENA DE BUENOS AIRES	LIBRERIA	ESMERALDA 882		
LIBRERIA HASTINAPURA	LIBRERIA	CHILE 1477		
HAPPY BOOKS	LIBRERIA	RIVADAVIA AV. 5462		
EL HABLADOR	LIBRERIA	CABILDO AV. 2280		
LIBRERIA GUIRAUD	LIBRERIA	DIAZ, CNEL. AV. 1492		
LIBRERIA GUADALUPITA	LIBRERIA	AVELLANEDA AV. 3918		
GOUT ELITE GASTRONOMICA	LIBRERIA	ECHEVERRIA 2077		
EL GLYPTODON	LIBRERIA	AYACUCHO 734		
GALERNA LIBROS. SUCURSAL CABILDO.	LIBRERIA	CABILDO AV. 1852		
GALERNA LIBROS. SUCURSAL URUGUAY.	LIBRERIA	URUGUAY 1049		
GALERNA LIBROS. SUCURSAL PERU.	LIBRERIA	PERU 1064		
LIBRERIA FERNANDEZ BLANCO	LIBRERIA	TUCUMAN 712		
AQUILANTI LIBROS	LIBRERIA	RINCON 79		
ENTELEQUIA COMIC BOOK STORE (SUCURSAL URUGUAY)	LIBRERIA	URUGUAY 341		
ENTELEQUIA COMIC BOOK STORE (SUCURSAL JURAMENTO)	LIBRERIA	JURAMENTO AV. 2584		
ENTRE LIBROS. SUCURSAL AV. SANTA FE.	LIBRERIA	SANTA FE AV. 2450		
ENTRE LIBROS. SUCURSAL AV. CABILDO.	LIBRERIA	CABILDO AV. 2280		
LIBRERIA EDIPO. SUCURSAL SANTA FE.	LIBRERIA	SANTA FE AV. 2691		
EDIPO LIBROS (SUCURSAL LAVALLE)	LIBRERIA	LAVALLE 1582		
EDIPO LIBROS (SUCURSAL AV. CORRIENTES)	LIBRERIA	CORRIENTES AV. 1686		
LIBRERIA SANTA FE. SUCURSAL ALTO PALERMO.	LIBRERIA	SANTA FE AV. 3253		
LIBRERIA SANTA FE. SUCURSAL SANTA FE II.	LIBRERIA	SANTA FE AV. 2582		
LIBRERIA SANTA FE. SUCURSAL CABILDO.	LIBRERIA	CABILDO AV. 605		
LIBRERIA NADIR. SUCURSAL CUENCA.	LIBRERIA	CUENCA 3131		
LIBRERIA NADIR. SUCURSAL LAS HERAS.	LIBRERIA	LAS HERAS, GENERAL 1702		
LIBRERIA NADIR. SUCURSAL SCALABRINI ORTIZ.	LIBRERIA	SCALABRINI ORTIZ, RAUL AV. 274		
LIBRERIA NADIR. SUCURSAL AV. CABILDO.	LIBRERIA	CABILDO AV. 1786		
LIBRERIA NADIR. SUCURSAL BRASIL.	LIBRERIA	BRASIL 1128		
LA OFERTA (SUCURSAL RIVADAVIA)	LIBRERIA	RIVADAVIA AV. 1711		
LIBRERIA YENNY. SUCURSAL ACOYTE.	LIBRERIA	ACOYTE AV. 44		
LIBRERIA YENNY. SUCURSAL AV. SANTA FE.	LIBRERIA	SANTA FE AV. 3253		
LIBRERIA YENNY. SUCURSAL ARCE.	LIBRERIA	ARCE 940		
PARQUE DE LA MEMORIA	CENTRO CULTURAL	OBLIGADO RAFAEL, AV.COSTANERA 6745		
CULTURA TANGUERA	MILONGA Y/O TANGUERIA	RIVADAVIA AV. 1392		
LA ISLA FM 89.9	RADIO LOCAL (AM Y FM)	SALGUERO, JERONIMO 2745		
CENTRO CULTURAL HORUS	CENTRO CULTURAL	CALVO, CARLOS Y TACUARI		
ASOCIACION CULTURAL ARMENIA	CENTRO CULTURAL	ARMENIA 1366		
CENTRO DE DIFUSION DE LA BUENA PRENSA	EDITORIAL	AYACUCHO 230		
BONUM	EDITORIAL	CORRIENTES AV. 6687		
BONSAI EDITORIAL	EDITORIAL	ELCANO AV. 3316		
DERECHO COOPERATIVO Y MUTUAL DCYM	EDITORIAL	BOGOTA 103		
EDICIONES AQUILINA	EDITORIAL	BALBIN, RICARDO, DR. AV. 2419		
EDITORIAL CCC EDUCANDO	EDITORIAL	GUIRALDES, INT. 2620		
PICTUS	EDITORIAL	MOZART 2370		
EDICIONES RAP	EDITORIAL	TALCAHUANO 638		
ELOISA CARTONERA	EDITORIAL	VALLE, ARISTOBULO DEL 666		
CAPITAL INTELECTUAL	EDITORIAL	PARAGUAY 1535		
EDITORIAL QUADRATA	EDITORIAL	CORRIENTES AV. 1471		
BARRY EDITORIAL	EDITORIAL	TALCAHUANO 638		
BIOCOLOR SRL	EDITORIAL	MONTAÃ‘ESES 2555		
BIFRONTE EDITORES	EDITORIAL	ECHEVERRIA 2492		
ACERCANDONOS MOVIMIENTO CULTURAL	EDITORIAL	COCHABAMBA 894		
EDICIONES CAMPO ESTRELLADO	EDITORIAL	LIBERTAD 567		
NUEVA VISION EDICIONES	EDITORIAL	TUCUMAN 3748		
EDITORIAL PENIEL	EDITORIAL	BOEDO 25		
EDICIONES SB	EDITORIAL	YAPEYU 283		
GRUPO CONVERGENCIA	EDITORIAL	BELGRANO AV. 680		
EDITORES DEL PUERTO	EDITORIAL	CORRIENTES AV. 1515		
DUNKEN EDITORIAL	EDITORIAL	AYACUCHO 355		
DEL ECLISE EDICIONES	EDITORIAL	ALVAREZ, JULIAN 841		
DEL DRAGON EDICIONES	EDITORIAL	MITRE, EMILIO 71		
DEL CANDIL EDICIONES	EDITORIAL	ESTEVEZ, JOSE, ING. 2184		
EDICIONES BIEBEL	EDITORIAL	BIEDMA, JOSE JUAN 1005		
EDITORIAL MUCHO GUSTO	EDITORIAL	MOREAU DE JUSTO, ALICIA AV. 2030		
URBE MULTIMEDIA	EDITORIAL	LORETO, VIRREY 3225		
EDICIONES CICCUS (CENTRO DE INTEGRACION, COMUNICACION, CULTURA Y SALUD)	EDITORIAL	MEDRANO AV. 288		
GRUPO EDAF EDICIONES ALGABA	EDITORIAL	CHILE 2222		
INSTITUTO DE PENSAMIENTO SOCIALISTA	EDITORIAL	RIOBAMBA 144		
EDITORIAL DE LA PALABRA DE DIOS	EDITORIAL	24 DE NOVIEMBRE 1212		
COLISION LIBROS	EDITORIAL	JUNIN 1616		
EDIMED SRL	EDITORIAL	PARAGUAY 2019		
AGEBE LIBROS	EDITORIAL	BOEDO AV. 1016		
DEL AULA TALLER EDICIONES	EDITORIAL	SAN BLAS 5421		
DE MENTE EDICIONES	EDITORIAL	CORRIENTES AV. 1312		
DE DIOS GUIAS DE VIAJE	EDITORIAL	TACUARI 131		
EDICIONES BIENVENIDAS	EDITORIAL	BELGRANO AV. 367		
D&D EDICIONES	EDITORIAL	ALSINA, ADOLFO 1535		
DEL NUEVO EXTREMO GRUPO EDITORIAL	EDITORIAL	CARRANZA, ANGEL JUSTINIANO 1852		
DEL SOL EDICIONES	EDITORIAL	CALLAO AV. 737		
EDICIONES DESDE LA GENTE	EDITORIAL	CORRIENTES AV. 1543		
DISTRIBUCIONES DEL FUTURO	EDITORIAL	PARACAS 59		
DOCENCIA SA	EDITORIAL	AGUERO 2260		
CAJA NEGRA EDITORA	EDITORIAL	AGUIRRE 1153		
CLASE TURISTA EDITORIAL	EDITORIAL	BONPLAND 1135		
EDITORIAL ENTROPIA	EDITORIAL	CESPEDES 3800		
LIBROS DE LA ARAUCAURIA	EDITORIAL	CASEROS AV. 410		
GZ EDITORES	EDITORIAL	PERU 457		
RETINA EDITORES	EDITORIAL	HIDALGO 775		
GOURMET MUSICAL EDICIONES	EDITORIAL	RUGGIERI, SILVIO L. 2733		
12(NTES)	EDITORIAL	JUSTO, JUAN B. AV. 4609		
CALESITA DE LA PLAZA ECHEVERRIA	CALESITA	NAHUEL HUAPI Y BAUNESS		
COMPAÑIA ARTISTICA ARCO IRIS	ESPACIO ESCENICO (TEATRO, MUSICA Y DANZA)	VENEZUELA 4001		
LO DE GUIDI	ESPACIO ESCENICO (TEATRO, MUSICA Y DANZA)	RIOBAMBA 359		
EL OJO	ESPACIO ESCENICO (TEATRO, MUSICA Y DANZA)	PERON, JUAN DOMINGO, TTE. GENERAL 2115		
CENTRO DE ESTUDIOS ARTISTICOS	ESPACIO DE FORMACION (CARRERAS, SEMINARIOS Y TALLERES)	CUENCA 3473		
GALERIA SCHLIFKA MOLINA ARTE	GALERIA DE ARTE	GORRITI 4829		
1/2 MUNDO CLUB DE ARTE	ESPACIO ESCENICO (TEATRO, MUSICA Y DANZA)	YRIGOYEN, HIPOLITO 2148		
CENTRO CULTURAL RAICES	ESPACIO ESCENICO (TEATRO, MUSICA Y DANZA)	AGRELO 3045		
GALPON V	ESPACIO ESCENICO (TEATRO, MUSICA Y DANZA)	VELEZ SARSFIELD AV. 218		
EL CARROMATO (SALA MOVIL)	ESPACIO ESCENICO (TEATRO, MUSICA Y DANZA)	ECHEVERRIA 2083		
CENTRO CULTURAL G.I.T.	ESPACIO ESCENICO (TEATRO, MUSICA Y DANZA)	CASTRO BARROS 1046		
CINE TEATRO BROWN	ESPACIO ESCENICO (TEATRO, MUSICA Y DANZA)	BROWN, ALTE. AV. 1375		
CENTRO LATINOAMERICANO DE CREACION E INVESTIGACION TEATRAL (CELCIT)LCIT	ESPACIO ESCENICO (TEATRO, MUSICA Y DANZA)	MORENO 431		
"TEATRO ESTUDIO ""EL CUERVO"""	ESPACIO ESCENICO (TEATRO, MUSICA Y DANZA)	SANTIAGO DEL ESTERO 433		
MIMOTEATRO ESCOBAR-LERCHUNDI	ESPACIO ESCENICO (TEATRO, MUSICA Y DANZA)	DEFENSA 611		
TEATRO LA RANCHERIA	ESPACIO ESCENICO (TEATRO, MUSICA Y DANZA)	MEXICO 1152		
EL BUHO	ESPACIO ESCENICO (TEATRO, MUSICA Y DANZA)	TACUARI 215		
SILENCIO DE NEGRAS	ESPACIO ESCENICO (TEATRO, MUSICA Y DANZA)	SAENZ PE�A, LUIS, PRES. 663		
DEL VIEJO PALERMO	ESPACIO ESCENICO (TEATRO, MUSICA Y DANZA)	CABRERA, JOSE A. 5567		
FUNDACION MITICA	ESPACIO ESCENICO (TEATRO, MUSICA Y DANZA)	THAMES 2078		
LA MARAVILLOSA. CASA DE ARTE.	ESPACIO ESCENICO (TEATRO, MUSICA Y DANZA)	MEDRANO 1360		
LA COMEDIA	ESPACIO ESCENICO (TEATRO, MUSICA Y DANZA)	RODRIGUEZ PE�A 1062		
GRAN REX	ESPACIO ESCENICO (TEATRO, MUSICA Y DANZA)	CORRIENTES AV. 857		
INSTITUTO NACIONAL DE ESTUDIOS DE TEATRO	MUSEO	SANTA FE AV. 1243		
INSTITUTO ESPACIO PARA LA MEMORIA	MUSEO	SAENZ PE�A, LUIS, PRES. 457		
MUSEO ANCONETANI DEL ACORDEON	MUSEO	GUEVARA 492		
MUSEO DE LA BALANZA	MUSEO	CALIFORNIA 2000		
MUSEO DE LAS ESCUELAS	MUSEO	PASEO COLON AV. 1318		
MUSEO MEMORIAS DE SAN JUAN EVANGELISTA	MUSEO	OLAVARRIA 486		
MUSEO CASA DE LA MONEDA. SOCIEDAD DEL ESTADO.	MUSEO	ANTARTIDA ARGENTINA AV. Y CASTILLO, RAMON S., PRES. AV.		
MUSEO DE BOMBEROS VOLUNTARIOS DE LA BOCA	MUSEO	BRANDSEN 567		
MUSEO DE LA DIPLOMACIA ARGENTINA	MUSEO	ARENALES 761		
MUSEO DE LA IGLESIA PARROQUIAL SAN PEDRO GONZALEZ TELMO Y SU CLAUSTRO HISTORICO	MUSEO	HUMBERTO 1 340		
MUSEO DE LA SOCIEDAD ARGENTINA DE ESCRITORES	MUSEO	MEXICO 524		
ACADEMIA NACIONAL DE LA HISTORIA DE LA REPUBLICA ARGENTINA	MUSEO	BALCARCE 139		
MUSEO ETNOGRAFICO DE LAS OBRAS MISIONALES PONTIFICIAS	MUSEO	MEDRANO AV. 735		
MUSEO HISTORICO DE LA HONORABLE CAMARA DE DIPUTADOS	MUSEO	MITRE, BARTOLOME 2085		
MUSEO DE LA INMIGRACION Y EX HOTEL DE INMIGRANTES	MUSEO	ANTARTIDA ARGENTINA AV. 1355		
MUSEO HISTORICO DEL REGIMIENTO GRANADEROS A CABALLO GENERAL SAN MARTIN	MUSEO	CAMPOS, LUIS M. AV. 554		
MUSEO PENITENCIARIO ARGENTINO ANTONIO BALLVE	MUSEO	HUMBERTO 1 378		
MUSEO HISTORICO DEL HOSPITAL RIVADAVIA	MUSEO	LAS HERAS GENERAL AV. 2670		
MUSEO DE LA LUZ	MUSEO	BOYACA 1553		
MUSEO DE LA PSICOLOGIA EXPERIMENTAL EN ARGENTINA ?DR. HORACIO G. PIÑERO?	MUSEO	INDEPENDENCIA AV. 3065		
MUSEO DE MARCAPASOS Y PRECURSORES DE LA MEDICINA MODERNA	MUSEO	CATAMARCA 536		
MUSEO DE PATOLOGIA DE LA UNIVERSIDAD DE BUENOS AIRES	MUSEO	URIBURU JOSE E., PRES. 950		
MUSEO Y OBSERVATORIO DEL COLEGIO SAN JOSE	MUSEO	MITRE, BARTOLOME 2455		
MUSEO DE TIRO FEDERAL	MUSEO	DEL LIBERTADOR AV. 6935		
MUSEO FORENSE DE LA MORGUE JUDICIAL	MUSEO	JUNIN 760		
MUSEO TECNOLOGICO EDUARDO LATZINA	MUSEO	PASEO COLON AV. 650		
MUSEO Y CENTRO DE ESTUDIOS HISTORICOS DE LA FACULTAD DE ODONTOLOGIA DE BUENOS AIRES DE LA UNIVERSIDAD DE BUENOS AIRES	MUSEO	ALVEAR, MARCELO T. DE 2142		
MUSEO DEL AUTOMOVIL CLUB ARGENTINO	MUSEO	DEL LIBERTADOR AV. 1850		
COLECCION DE ARTE AMALIA LACROZE DE FORTABAT	MUSEO	COSSETTINI, OLGA 141		
MUSEO AL AIRE LIBRE DE ARTISTAS PLASTICOS DE CAMINITO	MUSEO	CAMINITO Y ARAOZ DE LAMADRID, GREGORIO, GRAL.		
MUSEO DE ARTE CONTEMPORANEO BUENOS AIRES (MACBA)	MUSEO	SAN JUAN AV. 328		
MUSEO DE MAGDA FRANK	MUSEO	VEDIA 3546		
MUSEO LIBERO BADII	MUSEO	11 DE SEPTIEMBRE DE 1888 1990		
GALERIA AZUR	GALERIA DE ARTE	CALLAO AV. 1701		
FUNDACION LEBENSOHN	ESPACIO DE FORMACION (CARRERAS, SEMINARIOS Y TALLERES)	HORNOS, GRAL. 238		
AARS LIBREROS	LIBRERIA	LARREA 938		
ACME AGENCY. SUCURSAL ARENALES.	LIBRERIA	ARENALES 885		
ACME AGENCY. SUCURSAL CAMACUA.	LIBRERIA	CAMACUA 87		
AGUMALU	LIBRERIA	PERON, JUAN DOMINGO, TTE. GENERAL 2187		
ALBERTO PEREMIANSKY	LIBRERIA	CORDOBA AV. 2586		
ALIEN LIBROS	LIBRERIA	CORRIENTES AV. 1833		
ALMAGESTO	LIBRERIA	RODRIGUEZ PE�A 554		
ANDRES BELLO - TIENDA DE LIBROS	LIBRERIA	GORRITI 5204		
LIBRERIA ANTIGONA. SUCURSAL AV. CORRIENTES.	LIBRERIA	CORRIENTES AV. 1555		
LIBRERIA ANTIGONA. SUCURSAL AV. SANTA FE.	LIBRERIA	SANTA FE AV. 1654		
LIBRERIA ANTIGONA. SUCURSAL LAS HERAS.	LIBRERIA	LAS HERAS GENERAL AV. 2597		
LIBRERIA ANTIGONA. SUCURSAL CERRITO.	LIBRERIA	CERRITO 1128		
EDICIONES ARGENTINIDAD	EDITORIAL	FLORIDA 860		
ARLEQUIN LIBROS	LIBRERIA	JUNCAL 3404		
ARUNCO	LIBRERIA	COMBATE DE LOS POZOS 131		
ATHENAS	LIBRERIA	BIEDMA, JOSE JUAN 911		
BERNIE	LIBRERIA	MONTEVIDEO 295		
BOOKS	LIBRERIA	ALBERDI, JUAN BAUTISTA AV. 719		
MENDEZ GOMEZ	LIBRERIA	RIVADAVIA AV. 1623		
CALIGARI	LIBRERIA	BOGOTA 101		
LA REVISTERIA COMICS	LIBRERIA	CORRIENTES AV. 1388		
CANTERVILLE LIBROS	LIBRERIA	CONGRESO 2365		
CASASSA Y LORENZO LIBREROS. SUCURSAL PEDRO MORAN.	LIBRERIA	MORAN, PEDRO 3254		
CATERVA LIBROS	LIBRERIA	ESMERALDA 887		
CIENCIA Y TECNICA SERVICIOS BIBLIOGRAFICOS	LIBRERIA	TACUARI 1334		
CIENTIFICA INTERAMERICANA	LIBRERIA	ALVEAR, MARCELO T. DE 2147		
CINCO ESQUINAS	LIBRERIA	LIBERTAD 1293		
CINE SI	LIBRERIA	GIUFFRA, JOSE M.,DR. 311		
CLARETIANA EDITORIAL. SUCURSAL RODRIGUEZ PEÑA.	LIBRERIA	RODRIGUEZ PE�A 898		
CLARETIANA EDITORIAL. SUCURSAL ARAOZ.	LIBRERIA	ARAOZ 2968		
CLUB BURTON	LIBRERIA	ESTADOS UNIDOS 700		
CLUB DEL COMIC. SUCURSAL MARCELO T. DE ALVEAR.	LIBRERIA	ALVEAR, MARCELO T. DE 2002		
CLUB DEL COMIC. SUCURSAL MONTEVIDEO.	LIBRERIA	MONTEVIDEO 255		
CLUB DUMAS LIBROS	LIBRERIA	CORRIENTES AV. 1676		
COBRA. PEQUEÑA LIBRERIA.	LIBRERIA	ARANGUREN, JUAN F., DR. 150		
CONAS LIBROS	LIBRERIA	MITRE, BARTOLOME 2095		
LIBRERIA CONCENTRA	LIBRERIA	MONTEVIDEO 938		
LIBRERIA CONCENTRA. SUCURSAL CIUDAD UNIVERSITARIA.	LIBRERIA	GUIRALDES, INT. 2620		
CONRADO LIBROS	LIBRERIA	SAN MARTIN AV. 4521		
LA FABRICA	ESPACIO ESCENICO (TEATRO, MUSICA Y DANZA)	PERU 442		
ZAFRA	ESPACIO ESCENICO (TEATRO, MUSICA Y DANZA)	SARMIENTO 3096		
VUELA EL PEZ	ESPACIO ESCENICO (TEATRO, MUSICA Y DANZA)	CORDOBA AV. 4379		
LA CASA DEL ARBOL	ESPACIO ESCENICO (TEATRO, MUSICA Y DANZA)	FITZ ROY 2483		
LA OREJA NEGRA	ESPACIO ESCENICO (TEATRO, MUSICA Y DANZA)	URIARTE 1271		
CONTEXTO	LIBRERIA	BOCAYUVA, QUINTINO 22		
CP67 LIBRERIA TECNICA. SUCURSAL FLORIDA.	LIBRERIA	FLORIDA 683		
CP67 LIBRERIA TECNICA. SUCURSAL CIUDAD UNIVERSITARIA.	LIBRERIA	GUIRALDES, INT. 2620		
CRIME LIBROS	LIBRERIA	LAVALLE 985		
CRISMAR LIBROS	LIBRERIA	ALVAREZ JONTE AV. 4849		
CUEVA LIBROS	LIBRERIA	SARMIENTO 1566		
CULTURA LIBROS	LIBRERIA	LAS HERAS GENERAL AV. 3000		
D ARTAGNAN	LIBRERIA	AYACUCHO 455		
DE LA AVENIDA	LIBRERIA	DE MAYO AV. 924		
DE LA PAZ	LIBRERIA	ESTADOS UNIDOS 689		
DE LAS CIENCIAS	LIBRERIA	PARAGUAY 1363		
DE LAS LUCES	LIBRERIA	DE MAYO AV. 979		
DE LOS CUATRO VIENTOS. SUCURSAL BALCARCE.	LIBRERIA	BALCARCE 1053		
DE LOS CUATRO VIENTOS. SUCURSAL VENEZUELA.	LIBRERIA	REPUBLICA BOLIVARIANA DE VENEZUELA 726		
DEL AYER	LIBRERIA	CIUDAD DE LA PAZ 1403		
LIBRERIA DEL SOL	LIBRERIA	ESPINOSA 2393		
LIBRERIA DEL SUBURBIO	LIBRERIA	SAN JUAN AV. Y BOEDO AV.		
DEL SUR ANTICUARIOS	LIBRERIA	BOLIVAR 770		
LIBRERIA DEL VIRREY	LIBRERIA	LORETO, VIRREY 2407		
DELFOS LIBROS. SUCURSAL ELCANO.	LIBRERIA	ELCANO AV. 3258		
DEVA'S. SUCURSAL CORRIENTES.	LIBRERIA	CORRIENTES AV. 1752		
DEVA'S. SUCURSAL HONDURAS.	LIBRERIA	HONDURAS 4739		
DEVA'S. SUCURSAL SANTA FE.	LIBRERIA	SANTA FE AV. 1998		
DEVA'S. SUCURSAL JURAMENTO.	LIBRERIA	JURAMENTO AV. 2307		
DEVA'S. SUCURSAL ACOYTE.	LIBRERIA	ACOYTE AV. 70		
DEVA'S. SUCURSAL SAN JUAN.	LIBRERIA	SAN JUAN AV. 777		
DIMAR EDITORA	LIBRERIA	TRIUNVIRATO AV. 3523		
DISTAL LIBROS. SUCURSAL GUIDO.	LIBRERIA	GUIDO 1990		
EDILYR	LIBRERIA	TUCUMAN 1685		
EDUCALIBROS. SUCURSAL MALABIA.	LIBRERIA	MALABIA 2260		
EDUCALIBROS. SUCURSAL CHARCAS.	LIBRERIA	CHARCAS 4623		
EL ALEPH LIBROS	LIBRERIA	RIVADAVIA AV. 3972		
EL ALMACEN LIBROS	LIBRERIA	TALCAHUANO 231		
EL BANQUETE. SUCURSAL LA PAMPA.	LIBRERIA	LA PAMPA 2516		
EL GUALEGUAY LIBROS	LIBRERIA	PACHECO 2251		
EL INCUNABLE	LIBRERIA	MONTEVIDEO 1519		
EL JAGUEL	LIBRERIA	FLORIDA 835		
EL MILAGROSO	LIBRERIA	CUZCO 149		
EL PERSEGUIDOR	LIBRERIA	CORRIENTES AV. 1718		
EL RUFIAN MELANCOLICO	LIBRERIA	BOLIVAR 857		
EL VENTANAL	LIBRERIA	FLORIDA 835		
EL VITRAL	LIBRERIA	MONTEVIDEO 108		
EN EL CAMINO LIBROS. SUCURSAL BORGES.	LIBRERIA	BORGES, JORGE LUIS 1664		
EN EL CAMINO LIBROS. SUCURSAL CORRIENTES.	LIBRERIA	CORRIENTES AV. 1131		
ENCUENTRO SUDESTE	LIBRERIA	CORRIENTES AV. 1773		
ENLACE PORRUA S.A.	LIBRERIA	TUCUMAN 927		
ENTRE LINEAS	LIBRERIA	CUENCA 3375		
EPIFANIA LIBROS	LIBRERIA	LAVALLE 1910		
ESPACIO MOEBIUS	LIBRERIA	BULNES 658		
ESPARTACO. SUCURSAL SAN JUAN.	LIBRERIA	SAN JUAN AV. 2189		
ESPARTACO. SUCURSAL PEÑA.	LIBRERIA	RODRIGUEZ PE�A 130		
FERIA DE LIBROS	LIBRERIA	DE MAYO AV. 637		
FIGUEROA	LIBRERIA	MAIPU 898		
FIN DE SIGLO LIBROS	LIBRERIA	CORRIENTES AV. 1966		
GALERIA BUENOS AIRES	LIBRERIA	FLORIDA 833		
GALERNA LIBROS. SUCURSAL CORRIENTES.	LIBRERIA	CORRIENTES AV. 1743		
GALLO CANTOR	LIBRERIA	CORRIENTES AV. 1382		
GARCIA CAMBEIRO	LIBRERIA	COCHABAMBA 248		
GOLDFINGER	LIBRERIA	ANCASTE 3531		
GOURMAND PLACE	LIBRERIA	RODRIGUEZ PE�A 1182		
GRACIELA LIBROS / BOOK PRESS	LIBRERIA	PIROVANO 111		
GUADALQUIVIR. SUCURSAL MONTEVIDEO.	LIBRERIA	MONTEVIDEO 846		
GUADALQUIVIR. SUCURSAL RODRIGUEZ PEÑA.	LIBRERIA	RODRIGUEZ PE�A 744		
GUADALQUIVIR. SUCURSAL CALLAO.	LIBRERIA	CALLAO AV. 1012		
GUADALQUIVIR. SUCURSAL PARAGUAY.	LIBRERIA	PARAGUAY 1608		
GUADALQUIVIR. SUCURSAL PARANA.	LIBRERIA	PARANA 1017		
GUSTAVO MULTEDO	LIBRERIA	SANCHEZ DE BUSTAMANTE 515		
HAMMURABI	LIBRERIA	TALCAHUANO 440		
ICARO	LIBRERIA	BONPLAND 1562		
IMAGO MUNDI	LIBRERIA	ARROYO 971		
INCUNABLE SRL	LIBRERIA	DE MAYO AV. 637		
JOSE LIBRERIAS	LIBRERIA	SUIPACHA 336		
JUAN BLATON	LIBRERIA	FLORIDA 681		
JUAN ROLDAN	LIBRERIA	FLORIDA 835		
JUNCAL	LIBRERIA	TALCAHUANO 1288		
JURIDICA PUEYRREDON	LIBRERIA	PUEYRREDON AV. 2474		
JURIDICA	LIBRERIA	TALCAHUANO 434		
KIKER LIBROS	LIBRERIA	MITRE, BARTOLOME 2102		
LA ANTORCHA	LIBRERIA	RIVADAVIA AV. 4156		
LA BALLENA	LIBRERIA	DE MAYO AV. 937		
LA CALESITA	LIBRERIA	DE MAYO AV. 769		
LA CATEDRA	LIBRERIA	CORRIENTES AV. 1620		
LA CITA LIBROS	LIBRERIA	CHARCAS 3315		
LA COMPAÑIA DE LOS LIBROS	LIBRERIA	ARENALES 1901		
LA CRUZ DEL SUR	LIBRERIA	FLORIDA 835		
LA CUEVA LIBROS	LIBRERIA	DE MAYO AV. 1127		
LA INTERNACIONAL ARGENTINA	LIBRERIA	PADILLA 865		
LA JABONERIA	LIBRERIA	HUMBERTO 1 805		
LA LEY. SUCURSAL VIAMONTE.	LIBRERIA	VIAMONTE 1534		
LA LIBRE	LIBRERIA	BOLIVAR 646		
LA MAGA	LIBRERIA	GUEMES 3873		
LA OFERTA. SUCURSAL CORRIENTES II.	LIBRERIA	CORRIENTES AV. 1716		
LA PORTEÑA LIBROS	LIBRERIA	JURAMENTO AV. 1705		
LA VIDRIERA DEL LIBRO	LIBRERIA	CORRIENTES AV. 753		
LAS MIL Y UNA HOJAS. SUCURSAL LACROZE.	LIBRERIA	LACROZE, FEDERICO AV. 2219		
LAS MIL Y UNA HOJAS. SUCURSAL BERUTI.	LIBRERIA	BERUTI 3210		
LAS MIL Y UNA HOJAS. SUCURSAL CORDOBA.	LIBRERIA	CORDOBA AV. 960		
LECTURAS Y MELODIAS	LIBRERIA	MITRE, EMILIO 431		
LEER ES MUY BARATO	LIBRERIA	CORRIENTES AV. 1556		
LIBRERIA LEGENDA	LIBRERIA	CHARCAS 3279		
LEONARDO LERNER	LIBRERIA	LAS HERAS GENERAL AV. 2900		
LIBERIA LAJOUANE S.R.L.	LIBRERIA	PACHECO DE MELO, JOSE ANDRES 2036		
LIBRO FILM	LIBRERIA	CORRIENTES AV. 1145		
LIBRO FILM. SUCURSAL SANTA FE.	LIBRERIA	SANTA FE AV. 2450		
LIBROFUTBOL.COM	LIBRERIA	COSSETTINI, OLGA 1112		
LIBROS ALUVION	LIBRERIA	VIAMONTE 989		
LIBROS BALVANERA	LIBRERIA	AZCUENAGA 86		
LIBROS EN RED	LIBRERIA	SANTA FE AV. 1480		
LIBROS LA TEATRAL	LIBRERIA	LACROZE, FEDERICO 1860		
MACONDO LIBROS. SUCURSAL RUGGIERI.	LIBRERIA	RUGGIERI, SILVIO L. 2711		
LOS LIBROS MAS PEQUEÑOS DEL MUNDO	LIBRERIA	LAVALLE 835		
LILITH LIBROS	LIBRERIA	SANTA FE AV. 3753		
LORRAINE	LIBRERIA	CORRIENTES AV. 1513		
LIBRERIA LOS ANGELITOS	LIBRERIA	MONROE 5134		
LOS SIETE PILARES	LIBRERIA	FLORIDA 835		
LUCAS. SUCURSAL CORRIENTES.	LIBRERIA	CORRIENTES AV. 1247		
LUCAS. SUCURSAL URUGUAY.	LIBRERIA	URUGUAY 975		
LUNARIA LIBROS	LIBRERIA	IBERA 1629		
M. V. LIBROS	LIBRERIA	MAZA 912		
MADRE MARAVILLAS DE JESUS	LIBRERIA	ECHEVERRIA 2252		
MARIELA MANZUR	LIBRERIA	DEL LIBERTADOR AV. 7548		
MARTIN FIERRO	LIBRERIA	LOPE DE VEGA AV. 1773		
MARTINEZ	LIBRERIA	JUNIN 941		
MARTYCER. SUCURSAL MONROE I.	LIBRERIA	MONROE 2457		
MARTYCER. SUCURSAL MONROE III.	LIBRERIA	MONROE 5365		
MARTYCER. SUCURSAL MONROE II.	LIBRERIA	MONROE 4957		
MASCARO LIBROS	LIBRERIA	SANTA FE AV. 2928		
MATIAS	LIBRERIA	GASCON 73		
MEDIAPOLIS	LIBRERIA	GUIRALDES, INT. 2620		
MENENDEZ LIBROS	LIBRERIA	PARAGUAY 431		
MERCURIO	LIBRERIA	ROOSEVELT FRANKLIN D. AV. 5033		
MERIDIANA. SUCURSAL RODRIGUEZ PEÑA.	LIBRERIA	RODRIGUEZ PE�A 1034		
MERIDIANA. SUCURSAL RIVADAVIA.	LIBRERIA	RIVADAVIA AV. 5108		
MIREYA	LIBRERIA	FLORIDA 835		
MONK	LIBRERIA	CORRIENTES AV. 1671		
NELIDA DELL AQUILA	LIBRERIA	ALVAREZ THOMAS AV. 3335		
NUESTRA AMERICA	LIBRERIA	CALVO, CARLOS 1599		
NUEVA ERA LIBROS	LIBRERIA	FLORIDA 165		
NUEVA ROMA	LIBRERIA	SANTA FE AV. 2653		
OBEL LIBROS	LIBRERIA	CORRIENTES AV. 1230		
PAIDOS DEL FONDO	LIBRERIA	SANTA FE AV. 1685		
PALUMBO	LIBRERIA	CORRIENTES AV. 5457		
PAMPEANA	LIBRERIA	LIBERTAD 948		
PAN Y TRABAJO	LIBRERIA	CUZCO 150		
PANER	LIBRERIA	LAS HERAS GENERAL AV. 1938		
PAULINAS. SUCURSAL PUEYRREDON.	LIBRERIA	PUEYRREDON AV. 528		
PENELOPE LIBROS	LIBRERIA	SANTA FE AV. 3673		
PETRUS HELIOAGABALA	LIBRERIA	BLANCO ENCALADA 2540		
PORT	LIBRERIA	TALCAHUANO 447		
PROLOGO	LIBRERIA	FLORIDA 835		
PSICODEIA	LIBRERIA	URQUIZA, GRAL. 778		
PUERTA DEL SOL	LIBRERIA	PEDERNERA 88		
PUNTO Y APARTE	LIBRERIA	CORRIENTES AV. 1736		
RAYO ROJO	LIBRERIA	SANTA FE AV. 1670		
RINCON 9. SUCURSAL JUNIN.	LIBRERIA	JUNIN 74		
RINCON DEL ANTICUARIO	LIBRERIA	JUNIN 1270		
RIOS DE AGUA VIVA	LIBRERIA	TALCAHUANO 1211		
ROBERTO WERNER	LIBRERIA	SUCRE, ANTONIO JOSE DE, MCAL. 1180		
LIBRERIA RODRIGUEZ	LIBRERIA	CABILDO AV. 1849		
ROMANO	LIBRERIA	JUNIN 317		
RUDI B. SAZUNIC	LIBRERIA	TREINTA Y TRES ORIENTALES 957		
SAN BENITO	LIBRERIA	VILLANUEVA 955		
SAN JORGE	LIBRERIA	PERON, EVA AV. 5027		
SAN ROMAN	LIBRERIA	3 DE FEBRERO 990		
SANTA MARIA	LIBRERIA	RIVADAVIA AV. 8517		
SBS LIBRERIA INTERNACIONAL. SUCURSAL DISCEPOLO.	LIBRERIA	DISCEPOLO, ENRIQUE SANTOS 1875		
SBS LIBRERIA INTERNACIONAL. SUCURSAL SUCRE.	LIBRERIA	SUCRE, ANTONIO JOSE DE, MCAL. 2441		
SIRERA LIBROS	LIBRERIA	CORRIENTES AV. 1523		
SUDESTE LIBROS	LIBRERIA	CORRIENTES AV. 1117		
TEKNE	LIBRERIA	URQUIZA, GRAL. 772		
TERRA NOVA MAPS	LIBRERIA	FLORIDA 835		
TERRAMAR	LIBRERIA	DE MAYO AV. 1111		
TODO CBC	LIBRERIA	VIAMONTE 2011		
TODOTECNICAS	LIBRERIA	ALVEAR, MARCELO T. DE 1326		
ESPACIO JURIDICO	LIBRERIA	TALCAHUANO 487		
VICTOR AIZENMAN	LIBRERIA	LAS HERAS GENERAL AV. 2153		
VALENTE	LIBRERIA	LACROZE, FEDERICO AV. 3860		
VIVE LEYENDO - ANTIGUA FRAY MOCHO	LIBRERIA	SARMIENTO 1832		
CULTURAL ROFFO	BIBLIOTECA	SIMBRON 3058		
BIBLIOTECA OBRERA JUAN B. JUSTO	BIBLIOTECA	LA PLATA AV. 85		
BIBLIOTECA POPULAR VILLA PUEYRREDON NORTE	BIBLIOTECA	COCHRANE 2334		
BIBLIOTECA POPULAR DOMINGO FAUSTINO SARMIENTO	BIBLIOTECA	BUCARELLI 2583		
BIBLIOTECA POPULAR JOSE ENRIQUE RODO	BIBLIOTECA	ANDALGALA 2051		
BIBLIOTECA POPULAR CIENCIA Y LABOR	BIBLIOTECA	DIAZ, CESAR, GRAL. 2453		
BIBLIOTECA POPULAR AVELINO HERRERA	BIBLIOTECA	RIVADAVIA AV. 4950		
BIBLIOTECA POPULAR JOAQUIN V. GONZALEZ	BIBLIOTECA	PERON, JUAN DOMINGO, TTE. GENERAL 1242		
BIBLIOTECA POPULAR CARLOS VEGA BELGRANO	BIBLIOTECA	GARZON EUGENIO GENERAL 3780		
BIBLIOTECA POPULAR WILLIAM C. MORRIS	BIBLIOTECA	GUEMES 4621		
BIBLIOTECA POPULAR CORPORACION MITRE	BIBLIOTECA	ALVAREZ JONTE AV. 3176		
BIBLIOTECA POPULAR PUEYRREDON SUD	BIBLIOTECA	ESTADO PLURINACIONAL DE BOLIVIA 4801		
BIBLIOTECA POPULAR J. M. ESTRADA	BIBLIOTECA	RECONQUISTA 461		
BIBLIOTECA POPULAR EUSTAQUIO SANCHEZ	BIBLIOTECA	GUEVARA 464		
BIBLIOTECA POPULAR SATURNINO SEGUROLA	BIBLIOTECA	SEGUROLA AV. 1281		
BIBLIOTECA POPULAR 25 DE MAYO	BIBLIOTECA	BALBIN, RICARDO, DR. AV. 4221		
ASOCIACION CIRCULO CULTURAL Y DE FOMENTO BELISARIO ROLDAN	BIBLIOTECA	GALLARDO 616		
BIBLIOTECA POPULAR CENTRO PROT. REC. DE CHOFERES	BIBLIOTECA	AZCUENAGA 718		
BIBLIOTECA POPULAR JOSE MANUEL ESTRADA	BIBLIOTECA	FALCON, RAMON L.,CNEL. 5176		
BIBLIOTECA POPULAR DOMINGO F. SARMIENTO	BIBLIOTECA	BAIGORRIA 3373		
BIBLIOTECA POPULAR DE BARRACAS	BIBLIOTECA	JOVELLANOS, GASPAR M. DE 1051		
BIBLIOTECA POPULAR DR. ANGEL A. GIMENEZ	BIBLIOTECA	SUAREZ 1301		
BIBLIOTECA POPULAR EURINDIA	BIBLIOTECA	BRAGADO 5950		
BIBLIOTECA POPULAR UNIVERSIDAD POPULAR DE BELGRANO	BIBLIOTECA	CIUDAD DE LA PAZ 1972		
BIBLIOTECA POPULAR JUAN B. REBAGLIATI	BIBLIOTECA	LA FACULTAD 1772		
BIBLIOTECA POPULAR JUAN BAUTISTA ALBERDI	BIBLIOTECA	BRANDSEN 805		
BIBLIOTECA POPULAR ASOCIACION CIVIL LEOPOLDO MARECHAL	BIBLIOTECA	TRELLES, MANUEL R. 948		
BIBLIOTECA POPULAR CAROLINA MUZILLI ASOCIACION CIVIL	BIBLIOTECA	15 DE NOVIEMBRE DE 1889 1459		
BIBLIOTECA POPULAR LECTORES DEL PUEBLO	BIBLIOTECA	SAN PEDRITO 1026		
BIBLIOTECA POPULAR JUANA MANSO	BIBLIOTECA	LA RIOJA 1042		
FUNDACION NICOLAS GARCIA URIBURU (MUSEO DE ARTE PRECOLOMBINO)	MUSEO	BOLLINI 2260		
MUSEO DE LA CARICATURA SEVERO VACCARO	MUSEO	LIMA 1037		
MUSEO DR. GENARO GIACOBINI	MUSEO	CASEROS AV. 3087		
ASOCIACION CENTRO BETANZOS	CENTRO CULTURAL	REPUBLICA BOLIVARIANA DE VENEZUELA 1534		
CENTRO CULTURAL DE LOS ARTISTAS	CENTRO CULTURAL	MAGALLANES 861		
ASOCIACION ITALIANA DE MUTUALIDAD E INSTRUCCION UNIONE E BENEVOLENZA	ESPACIO DE FORMACION (CARRERAS, SEMINARIOS Y TALLERES)	PERON, JUAN DOMINGO, TTE. GENERAL 1362		
CENTRO METROPOLITANO DE DISEÑO (CMD)	ESPACIO DE FORMACION (CARRERAS, SEMINARIOS Y TALLERES)	ALGARROBO 1041		
SAMY RECORDS	DISQUERIA	SAN MARTIN AV. 2450		
CENTRO CULTURAL EL PERRO	CENTRO CULTURAL	SUAREZ 3000		
MUSEO DE INFORMATICA, COMPUTADORAS Y ACCESORIOS INFORMATICOS	MUSEO	TUCUMAN 810		
EL FARO	BAR ELEMENTO	DE LOS CONSTITUYENTES AV. 4099		
LA ESCUELA	BAR ELEMENTO	PEDRAZA, MANUELA 2803		
EL MOTIVO	BAR ELEMENTO	CARRIL, SALVADOR MARIA DEL AV. 2400		
SAN BERNARDO	BAR ELEMENTO	CORRIENTES AV. 5436		
BAR BAUNESS	BAR ELEMENTO	BAUNESS 2561		
EL BOLICHE DE ROBERTO	BAR ELEMENTO	BULNES 331		
FLORIDA	BAR ELEMENTO	BOEDO AV. 944		
ALENJO	BAR ELEMENTO	BOEDO AV. 825		
BAR OVIEDO	BAR ELEMENTO	DE LA TORRE, LISANDRO AV. 2407		
LOS BILLARES DE MATADEROS	BAR ELEMENTO	DE LOS CORRALES AV. 7300		
MAR AZUL	BAR ELEMENTO	TUCUMAN 1700		
BOHEMIA	BAR ELEMENTO	CABILDO AV. 4212		
CAFE SAAVEDRA	BAR ELEMENTO	BALBIN, RICARDO, DR. AV. 4008		
BAR CONDE	BAR ELEMENTO	CONDE 701		
CAFE DE GARCIA	BAR ELEMENTO	SANABRIA 3302		
YATASTO	BAR ELEMENTO	SAN MARTIN AV. 3201		
SALON URQUIZA	BAR ELEMENTO	MENDOZA 4973		
BARCELONA	BAR ELEMENTO	CORDOBA AV. 5895		
EL VIEJO BUZON	BAR ELEMENTO	NEUQUEN 1100		
BAR EL MODELO	BAR ELEMENTO	SANTANDER 487		
CAFESUA	BAR ELEMENTO	CASEROS AV. 3699		
BANCO BAR	BAR ELEMENTO	ALBERDI, JUAN BAUTISTA AV. 5496		
TRES AVENIDAS	BAR ELEMENTO	DIRECTORIO AV. 4302		
EL BODEGON DE VILLA LURO	BAR ELEMENTO	RIVADAVIA AV. 9800		
CAFE MIRANDA	BAR ELEMENTO	LOPE DE VEGA AV. 1501		
CLARO	BAR ELEMENTO	LOPE DE VEGA AV. 1400		
VARELA VARELITA	BAR ELEMENTO	SCALABRINI ORTIZ, RAUL AV. 2100		
STAZIONE CAFE GOURMET	BAR ELEMENTO	JUNCAL 2002		
SAN JOSE	BAR ELEMENTO	CALVO, CARLOS 1400		
CONFITERIA LA UNION	BAR ELEMENTO	BELGRANO AV. 1101		
LA ORQUIDEA	BAR ELEMENTO	CORRIENTES AV. 4101		
LA LAGUNA	BAR ELEMENTO	PERON, EVA AV. Y LAGUNA		
RAFYS	BAR IDENTIFICADO	CONGRESO AV. Y CRAMER AV.		
LOS 3 HERMANOS	BAR IDENTIFICADO	FOREST AV. 317		
LA GENTILEZA	BAR IDENTIFICADO	LACROZE, FEDERICO AV. 3800		
BAR DE EL GALLEGO	BAR IDENTIFICADO	BONPLAND 1703		
CAFE LA UNION	BAR IDENTIFICADO	CONGRESO AV. 3899		
BAR RODNEY	BAR IDENTIFICADO	RODNEY 400		
GUARDA LA VIEJA	BAR IDENTIFICADO	BILLINGHURST 699		
SANATA BAR	BAR IDENTIFICADO	SARMIENTO 3501		
EL IMAGINARIO CULTURAL	BAR IDENTIFICADO	BULNES 899		
LA CASONA DE HUMAHUACA	BAR IDENTIFICADO	HUMAHUACA 3508		
MUSSETTA	BAR IDENTIFICADO	BILLINGHURST 894		
PAN Y ARTE	BAR IDENTIFICADO	BOEDO AV. 880		
MARGOT	BAR IDENTIFICADO	BOEDO AV. 857		
ESQUINA HOMERO MANZI	BAR IDENTIFICADO	SAN JUAN AV. 3601		
CAFE DE LA SUBASTA	BAR IDENTIFICADO	RIO DE JANEIRO 54		
MAILIN	BAR IDENTIFICADO	CHICLANA AV. 4258		
LE PAYSAGE	BAR IDENTIFICADO	COBO AV. 1102		
TAXCO CAFE	BAR IDENTIFICADO	ALBERDI, JUAN BAUTISTA AV. 6099		
DE LOS CORRALES	BAR IDENTIFICADO	DE LOS CORRALES AV. 6799		
CATEDRAL DEL TANGO	BAR IDENTIFICADO	DE LOS CORRALES AV. 6599		
LOS CUATRO ASES	BAR IDENTIFICADO	FERNANDEZ DE LA CRUZ, F., GRAL. AV. Y PORTELA		
ESQUINA ALBERDI	BAR IDENTIFICADO	ALBERDI, JUAN BAUTISTA AV. 1907		
PIZZA PAZZA	BAR IDENTIFICADO	AVELLANEDA AV. 4199		
ESQUINA JONTE	BAR IDENTIFICADO	ALVAREZ JONTE AV. 5799		
PICHIN	BAR IDENTIFICADO	DE MAYO AV. 806		
LA OPERA	BAR IDENTIFICADO	CORRIENTES AV. 1799		
BAR IBERIA	BAR IDENTIFICADO	DE MAYO AV. 1196		
CAFE Y BAR RONAS	BAR IDENTIFICADO	DE MAYO AV. 999		
CAFE DE LA JUNTA DE 1810	BAR IDENTIFICADO	DE MAYO AV. 639		
BAR LONDON CITY	BAR IDENTIFICADO	DE MAYO AV. 599		
SAN MARTIN	BAR IDENTIFICADO	BELGRANO AV. 901		
HOLM BAR	BAR IDENTIFICADO	HOLMBERG 2637		
CAFE VIA LACROZE	BAR IDENTIFICADO	LACROZE, FEDERICO AV. 2801		
CAFE DE LA U	BAR IDENTIFICADO	TRIUNVIRATO AV. 4801		
BAHIA	BAR IDENTIFICADO	SAENZ AV. 1455		
EL ENCUENTRO	BAR IDENTIFICADO	DE LA TORRE, LISANDRO AV. 2381		
CAFE AVENIDA	BAR IDENTIFICADO	PERON, EVA AV. Y MEDINA		
LA POPULAR	BAR IDENTIFICADO	PERON, EVA AV. 4246		
SEPTIMO ARTE	BAR IDENTIFICADO	SAN PEDRITO AV. 107		
LA FORJA	BAR IDENTIFICADO	BACACAY 2414		
LA FARMACIA	BAR IDENTIFICADO	DIRECTORIO AV. 2400		
LOS MEJORES	BAR IDENTIFICADO	CARABOBO AV. 17		
LA ESTACION	BAR IDENTIFICADO	BAHIA BLANCA 100		
EL GARFIO	BAR IDENTIFICADO	DIRECTORIO AV. Y ACOSTA, MARIANO AV.		
SANTA CLARA	BAR IDENTIFICADO	CARRASCO AV. 23		
CAFE ROCK DE LA VE	BAR IDENTIFICADO	LOPE DE VEGA 250		
SISONO CAFE	BAR IDENTIFICADO	IRIGOYEN 39		
EL OLIMPO	BAR IDENTIFICADO	IRIGOYEN 1491		
CAFE DORREGO	BAR IDENTIFICADO	DEFENSA 1098		
BRITANICO	BAR IDENTIFICADO	BRASIL AV. 399		
ROMA	BAR IDENTIFICADO	OLAVARRIA 409		
ACONCAGUA	BAR IDENTIFICADO	ESTADOS UNIDOS 502		
LA GIRALDA	BAR IDENTIFICADO	CORRIENTES AV. 1453		
AUDITORIO BELGRANO	ESPACIO ESCENICO (TEATRO, MUSICA Y DANZA)	LORETO, VIRREY 2348		
ARTE MULTIPLEX	CINE	CABILDO AV. 2829		
MARGEN DEL MUNDO (MUSEO DE PERIODISMO)	MUSEO	ARENAL, CONCEPCION 4865		
LA GRAN JAIME	CENTRO CULTURAL	ARAOZ 832		
CENTRO CULTURAL KIRCHNER	CENTRO CULTURAL	SARMIENTO 151		
LA ABADIA. CENTRO DE ARTE Y ESTUDIOS LATINOAMERICANOS	CENTRO CULTURAL	GOROSTIAGA 1908		
